Redemonstration of the left basilar patchy atelectasis, unchanged from last exam. Lungs are otherwise clear. No evidence of pneumothorax or pleural effusions present. There is a focal calcified nodules in the left upper lung, stable in appearance from XXXX of XXXX. The cardiomediastinal silhouette is unremarkable. No suspicion bony destruction identified.	Pulmonary Atelectasis / base / left / patchy ; Nodule / lung / upper lobe / left / focal ; Calcinosis / lung / upper lobe / left	No acute cardiopulmonary abnormality.	Pt is pre-op R carotid artery repair; XXXX XXXX XXXX/XXXX/SOB; no Hx smoking; XXXX XXXX L carotid artery repair in XXXX; pt has XXXX both XXXX operated on for rotator XXXX.
There is no focal consolidation, pleural effusions, or pneumothoraces. Scattered calcified nodules compatible with granulomatous disease. Cardiomediastinal silhouette is within normal limits. No masses or suspicious nodules. XXXX are unremarkable.	Calcified Granuloma / scattered ; Granulomatous Disease	1. No acute cardiopulmonary abnormality. 2. No suspicious masses or nodules.	Long history of smoking, now with history of XXXX loss
Normal cardiac contours. Clear lung XXXX bilaterally. No pneumothorax or pleural effusion.	normal	No acute cardiopulmonary abnormalities.	XXXX-year-old female with chest pain.
Left midlung opacity noted, not visualized on prior. Heart size within normal limits. No pleural effusions. No evidence of pneumothorax. Osseous structures intact.	Opacity / lung / lingula ; Pulmonary Atelectasis / lingula ; Infiltrate / lung / lingula	Left mid lung opacity noted, most compatible with atelectasis versus infiltrate. Recommend clinical correlation. .	XXXX-year-old male, XXXX, shortness of breath, question pneumonia.
Heart size normal. Lungs are clear. XXXX are normal. No pneumonia, effusions, edema, pneumothorax, adenopathy, nodules or masses.	normal	Normal chest.	chest pain history of Hodgkin's disease
Cardiac and mediastinal XXXX appear normal. No visible pneumothorax, focal airspace opacity, or pleural effusion is seen. No visible free air under the diaphragm. The osseous structures appear intact.	normal	No acute radiographic cardiopulmonary process. .	XXXX-year-old male, hemoptysis, chest pain and shortness of breath.
Stable mild thoracic levoscoliosis. Stable cardiomegaly. Multiple scattered round calcific densities XXXX represent old granulomatous disease. No pneumothorax or pleural effusion. No focal consolidation. Moderate degenerative changes of the thoracic spine.	Scoliosis / thoracic vertebrae / left / mild ; Cardiomegaly ; Calcinosis / thorax / scattered / round / multiple ; Density / thorax / scattered / round / multiple ; Granulomatous Disease ; Thoracic Vertebrae / degenerative / moderate	Stable cardiomegaly with no focal airspace disease.	XXXX-year-old female with asthma flare.
Mediastinal contours are normal. Lungs are clear. There is no pneumothorax or large pleural effusion.	normal	No acute cardiopulmonary abnormality.	Shortness of breath
The heart, pulmonary XXXX and mediastinum are within normal limits. There is no pleural effusion or pneumothorax. There is no focal air space opacity to suggest a pneumonia. There are mild degenerative changes of the spine.	Spine / degenerative / mild	No acute cardiopulmonary disease.	XXXX-year-old with chest pain intermittently over the last 2 weeks.
The XXXX examination consists of frontal and lateral radiographs of the chest. Sternotomy XXXX and surgical clips are again seen. The cardiomediastinal contours are unchanged. There is a background of marked centrilobular emphysema. Streaky opacities in the lung bases may represent atelectasis or scarring. There is no consolidation, pleural effusion or pneumothorax.	Surgical Instruments ; Pulmonary Emphysema / severe ; Opacity / lung / base / bilateral / streaky	No evidence of acute cardiopulmonary disease or significant interval change.	Dyspnea.
No focal lung consolidation. A XXXX density overlying the left costophrenic XXXX is XXXX due to overlying soft tissues. Heart size and pulmonary vascularity are within normal limits. No pneumothorax or pleural effusion. Osseous structures are grossly intact.	Density / costophrenic angle / left	No acute cardiopulmonary process.	Postop patient with XXXX
Finding data is null	normal	Heart size within normal limits for technique. No focal alveolar consolidation, no definite pleural effusion seen. No typical findings of pulmonary edema. No pneumothorax.	XXXX-year-old male, syncope
Normal and stable cardiomediastinal contours. No pneumothorax, pleural effusions or significant pulmonary edema. No focal lung consolidation.	normal	1. No acute cardiopulmonary abnormalities.	Chest pain
Again noted and is blunting of the right pleural space, XXXX a XXXX effusion or scarring. Opacity in the right lung base also appears unchanged, XXXX scarring. Heart size appears normal, improved from prior study. There is no vascular congestion or edema. There's no pneumothorax.	Pleura / right / blunted ; Pleural Effusion / right ; Cicatrix / pleura / right ; Opacity / lung / base / right ; Cicatrix / lung / base / right ; Thickening / pleura / right	1. Stable right basilar scarring and right pleural thickening	Kidney transplant evaluation
The heart, pulmonary XXXX and mediastinum are within normal limits. There is no pleural effusion or pneumothorax. There is no focal air space opacity to suggest a pneumonia. There are degenerative changes of the spine.	Spine / degenerative	No acute cardiopulmonary disease.	XXXX-year-old with for preop evaluation for knee XXXX.
Heart size and mediastinal contours are within normal limits. Diffuse bilateral calcified sequelae of prior granulomatous infection. No pulmonary vascular congestion. No XXXX edema. No focal consolidation. There is no visible pleural effusion or pneumothorax. There is mild anterior wedging of a lower thoracic vertebral body, approximately T11 level.	Granulomatous Disease ; Calcinosis / bilateral / diffuse ; Deformity / thoracic vertebrae / anterior / mild	1. No acute cardiopulmonary abnormality. 2. Mild age indeterminate anterior wedging at the T11 level.	XXXX onset shortness of breath. Hypoxia with oxygen saturation at 79% on room air. 98% on 6 liters.
Finding data is null	Opacity / lung / left ; Aorta, Thoracic / tortuous ; Opacity / retrocardiac ; Pulmonary Atelectasis / focal ; Cicatrix / lung / left	Some XXXX opacities left mid lung compatible with focal subsegmental atelectasis/scarring. No acute airspace disease or effusions. Heart appears prominent. Some tortuosity thoracic aorta. Midline retrocardiac opacity suggestive of a small hiatal hernia.	Bronchitis.
Chest. Both lungs clear and expanded. Heart and mediastinum normal. Ankle. Soft tissue XXXX is present around the malleoli. XXXX intact. Mortise radiographically stable.	normal	1. Chest. No active disease. No evidence for cardiopulmonary injury. 2. Left ankle. Soft tissue edema with no visible bony injury.	Chest and ankle pain after XXXX.
The cardiac contours are normal. Cardiac valve replacement. The lungs are clear. Thoracic spondylosis.	Spondylosis / thoracic vertebrae ; Surgical Instruments	No acute process.	Preop bariatric surgery
No pneumothorax, pleural effusion or airspace consolidation. Cardiomediastinal size is within normal limits. Pulmonary vasculature is normal . XXXX XXXX intact. Chondral cartilages causing XXXX over the anterior lungs on lateral view.	No Indexing	No acute cardiopulmonary abnormality. .	The patient is a XXXX-year-old male, preop for bilateral TKA. Nonsmoker, cardiac stent XXXX. Otherwise no complaints.
Changes post bilateral thoracotomy and XXXX sternotomy. Intact XXXX XXXX. Stable position of the epicardial XXXX XXXX. Mild cardiomegaly. The lungs are clear. Bilateral small pleural effusions.	Cardiomegaly / mild ; Pleural Effusion / bilateral / small	1. Stable postop changes with mild cardiomegaly. 2. Small bilateral pleural effusions.	DORV, post surgery
The lungs and pleural spaces show no acute abnormality. Heart size and pulmonary vascularity within normal limits.	normal	1. No acute pulmonary abnormality.	Difficulty breathing
No large pleural effusions. No pneumothorax. No focal airspace opacities. Heart size is normal.	normal	No acute cardiopulmonary abnormalities.	XXXX-year-old male with chest pain
The lungs appear clear. Lung volumes are low. The heart and pulmonary XXXX appear normal. Pleural spaces are clear.	Lung / hypoinflation	No acute cardiopulmonary disease.	,786.52 XXXX
There is enlargement of the cardiac silhouette. There is a focal opacity within the right upper lung. There is dense calcification of the thoracic aorta. There is no pneumothorax. There is no large pleural effusion.	Cardiac Shadow / enlarged ; Opacity / lung / upper lobe / right / focal ; Calcinosis / aorta, thoracic / severe	1. Right upper lobe opacity. Without comparisons, this may represent a focal area of infection/pneumonia. However, correlation should be XXXX for possible tuberculosis exposure as tuberculosis infection could have this appearance. If discordant from clinical suspicion, or does not resolve on follow up imaging, consider further evaluation with XXXX scan. 2. Enlargement of the cardiac silhouette.	Head bleed.
The lungs are clear. There is no pleural effusion or pneumothorax. The heart and mediastinum are normal. The skeletal structures are normal.	normal	No acute pulmonary disease.	Chest pressure on left
There are T-spine osteophytes. There calcified costochondral cartilages. There is loss of disc XXXX of a midthoracic vertebral body. There are streaky opacities in both lung bases which may represent atelectasis or scarring. No pneumothorax. The heart is borderline enlarged.	Osteophyte / thoracic vertebrae / multiple ; Opacity / lung / base / bilateral / streaky ; Cardiomegaly / borderline ; Deformity / thoracic vertebrae	1. Borderline cardiomegaly. 2. Age-indeterminate, XXXX chronic, XXXX deformity in the midthoracic spine.	Pain, weakness
Stable cardiomediastinal silhouette. Mild patchy right upper lobe opacities, similar to slightly improved from XXXX. Left lung clear. No pleural effusion or pneumothorax.	Opacity / lung / upper lobe / right / patchy / mild ; Infiltrate / lung / upper lobe / right / mild	1. Persistent mild right upper lobe infiltrate, similar to slightly improved from XXXX. 2. Left lung grossly clear.	XXXX-year-old male with chest pain.
There are intact midline sternotomy XXXX and postsurgical changes of prior CABG. The aorta is unfolded. The heart size and cardiomediastinal silhouette are normal. There is no focal airspace opacity, pleural effusion, or pneumothorax. There are mild degenerative changes in the thoracic spine.	Aorta / tortuous ; Thoracic Vertebrae / degenerative / mild	No acute cardiopulmonary finding.	XXXX-year-old male with dyspnea.
There are numerous surgical clips at the thoracic inlet. Small areas of XXXX scarring are seen in the left base. The lungs are otherwise clear. There is no pleural effusion or pneumothorax. The heart and mediastinum are normal. The skeletal structures are normal.	Surgical Instruments / thorax ; Cicatrix / lung / base / left / small	No acute pulmonary disease.	Vomiting beginning last XXXX. XXXX
Heart size remains slightly large. Aorta remains tortuous. Pulmonary XXXX remain normal. No infiltrates or masses in the lungs.	Cardiomegaly / mild ; Aorta / tortuous	Continued slight cardiomegaly with no evidence for failure or pneumonia.	dyspnea
The lungs are clear. The heart and pulmonary XXXX are normal. Pleural spaces are clear. Mediastinal contours are normal. There is no pneumothorax.	normal	No acute cardiopulmonary disease	,786.2 XXXX
Normal heart size and mediastinal contours. The lungs are free of any focal airspace disease. In the left lung base, there is a 9 mm nodule that not definitively calcified. No pneumothorax or pleural effusion. No acute bony abnormalities.	Nodule / lung / base / left	1. No acute cardiopulmonary process. 2. 9 mm left lower lobe pulmonary nodule not definitively calcified. Recommend comparison with prior images to document stability. If none are available consider nonemergent XXXX chest for further characterization. .	Abdominal pain.
Finding data is null	normal	Heart size near top normal limits, stable mediastinal contours. No focal alveolar consolidation, no definite pleural effusion seen. No typical findings of pulmonary edema.	XXXX-year-old male, pain
Finding data is null	normal	The heart size is top normal, cardiomediastinal silhouette within normal limits. Pulmonary vasculature appears normal. There is no focal air space consolidation. No pleural effusion or pneumothorax.	Chest congestion, XXXX for one XXXX.
There are XXXX opacities in the left lung, XXXX subsegmental atelectasis. XXXX opacities overlying the left lung base on the frontal XXXX XXXX reflect epicardial fat XXXX and overlying breast tissue. There is no focal airspace consolidation. No pleural effusion or pneumothorax. Heart size is at the upper limits of normal. There are diffuse degenerative changes of the spine.	Opacity / lung / left ; Pulmonary Atelectasis / lingula ; Spine / degenerative / diffuse ; Epicardial Fat ; Opacity / lung / base / left	No acute findings. Left mid lung subsegmental atelectasis.	XXXX-year-old female, preoperative evaluation
Defibrillator XXXX is in stable position. The XXXX and soft tissue appear normal. The cardiac silhouette and mediastinum size are normal. The aortic XXXX is on the left. The trachea is well seen and appears normal. The lungs are clear.	Implanted Medical Device	Stable position of the defibrillator XXXX.	defibrillator, XXXX CHEST X-XXXX XXXX XXXX and LATERAL DATED XXXX . COMPARISON : XXXX.
The cardiomediastinal silhouette is within normal limits for size and contour. Calcified right lower lobe granuloma The lungs are normally inflated without evidence of focal airspace disease, pleural effusion, or pneumothorax. Degenerative changes of the spine.	Calcified Granuloma / lung / lower lobe / right ; Spine / degenerative	1. No acute radiographic cardiopulmonary process.	XXXX
Cardiac and mediastinal contours are unremarkable. Pulmonary vascularity is within normal limits. No focal air space opacities, pleural effusion, or pneumothorax. XXXX are grossly unremarkable.	normal	1. Clear lungs.	XXXX year-old female, preop XXXX with XXXX.
Finding data is null	Nodule / lung / lingula	1. XXXX 1.9 XXXX left midlung nodule without XXXX benign calcification. CT of the chest is recommended to further evaluate for possible malignancy. 2. Heart size and mediastinal silhouette appear within normal limits. Normal vascularity. No pleural effusions or pneumothorax. Critical results discussed XXXX. XXXX at the time of interpretation, XXXX, XXXX XXXX hours XXXX telephone.	XXXX-year-old with XXXX, vomiting
The heart size and mediastinal silhouette are within normal limits for contour. The lungs are clear. No pneumothorax or pleural effusions. The XXXX are intact.	normal	No acute cardiopulmonary abnormalities.	XXXX-year-old male with chest pain involved in MVA.
The heart size and pulmonary vascularity appear within normal limits. The lungs are free of focal airspace disease. No pleural effusion or pneumothorax is seen. A few bandlike opacities are present which are XXXX to represent small areas of scarring or atelectasis. There is eventration of the right hemidiaphragm. Calcified granuloma is present in the left lung.	Opacity / thorax / multiple / small ; Cicatrix / mild ; Pulmonary Atelectasis ; Diaphragmatic Eventration / right ; Calcified Granuloma / lung / left	No evidence of active disease.	Bone marrow transplant evaluation
Finding data is null	Nodule / thorax / left	Vague 1.5 cm nodule left mid chest periphery overlying the posterior lateral left 7th rib. Further evaluation will require a chest CT. Remainder of the lungs are clear. There is no effusion or adenopathy. Heart size is normal.	cigarette smoking with XXXX
Stable mild cardiomegaly. No pneumothorax, pleural effusion, or focal airspace disease. Bony structures intact. Right humeral head bone anchor.	Cardiomegaly / mild ; Implanted Medical Device / humerus / right	Stable mild cardiomegaly without acute cardiopulmonary abnormality.	XXXX-year-old female with chest pain.
Heart size normal. Lungs are clear. XXXX are normal. No pneumonia, effusions, edema, pneumothorax, adenopathy, nodules or masses.	normal	Normal chest.	XXXX
Finding data is null	normal	Heart size normal. Mediastinal silhouette and pulmonary vascularity are within normal limits. There is no focal airspace consolidation, pleural effusion or pneumothorax.	Chest pain
Sternotomy XXXX noted. Suture material overlies the left upper lobe. Heart size within normal limits. Negative for focal pulmonary consolidation, pleural effusion or pneumothorax. Scarring left costophrenic XXXX, unchanged. Calcified granulomas noted.	Sutures / lung / upper lobe / left ; Cicatrix / costophrenic angle / left ; Calcified Granuloma / multiple	No acute abnormality.	XXXX-year-old XXXX, chest pain.
The heart size and pulmonary vascularity appear within normal limits. Left XXXX-a-XXXX is in XXXX. No pleural effusion or pneumothorax is seen. Right upper lobe area of dense opacity is seen in the medial right apex. On a previous outside XXXX scan (XXXX), the right upper lobe was consolidated. Comparison to the XXXX XXXX from that exam shows this opacity to have decreased. No films were available, however, for direct comparison.	Density / lung / apex / right ; Opacity / lung / apex / right	1. Right upper lobe opacity which appears improved as compared to previous XXXX scan.	Hodgkin's disease. XXXX for two weeks.
The heart and lungs have XXXX XXXX in the interval. Both lungs are clear and expanded. Heart and mediastinum normal.	No Indexing	No active disease.	60y male with rt sided chest pain
The heart is normal in size. The mediastinum is unremarkable. The lungs are clear.	normal	No acute disease.	HYPERTENSION; preop
Finding data is null	normal	Comparison XXXX, XXXX. No suspicious appearing lung nodules. Well-expanded and clear lungs. Mediastinal contour within normal limits. No acute cardiopulmonary abnormality identified. Stable chest.	,174.9 breast cancer. XXXX XXXX.
There is stable cavity in the right apex, XXXX related to prior tuberculosis infection. There is increased opacity in the left upper lobe, peripherally. There is pulmonary hyperexpansion. There is no large effusion or pneumothorax.	Cavitation / lung / apex / right ; Tuberculosis ; Opacity / lung / upper lobe / left ; Lung / hyperdistention ; Opacity / lung / upper lobe / right	Right upper lobe cavity, consistent with prior tuberculous infection. There is increased right upper lobe opacities XXXX compared to the prior study. This could represent reactivation of tuberculosis or other infection.	Shortness of breath
Heart size is mildly enlarged. The pulmonary XXXX and mediastinum are within normal limits. There is biapical scarring noted. There is slight bilateral costovertebral XXXX blunting which may indicate XXXX effusions. No pneumothorax is identified. There is no focal air space opacity to suggest a pneumonia. There is a left-sided dual-XXXX XXXX unchanged from the comparison study with leads in expected position.	Cardiomegaly / mild ; Cicatrix / lung / apex / bilateral ; Implanted Medical Device / left	Left-sided dual-XXXX pacemaker as expected. Possible XXXX effusions.	XXXX-year-old post pacemaker implantation. Left arm in a sling.
Sequelae of old granulomatous disease. Lungs are clear without focal consolidation. No pleural effusions or pneumothoraces. Heart and mediastinum of normal size and contour.	Granulomatous Disease	Clear lungs.	Bone marrow transplant XXXX, XXXX.
Stable calcified superior mediastinal lymph XXXX. Lungs are clear bilaterally. There is no focal consolidation, pleural effusion, or pneumothoraces. Cardiomediastinal silhouette is within normal limits. XXXX are unremarkable.	Calcinosis / mediastinum / lymph nodes	No acute cardiopulmonary abnormality.	Bronchitis, hemoptysis
Left-sided dual-XXXX cardiac XXXX in stable position. The heart is of normal size. Interval decrease and left basilar opacity. Increase in XXXX opacities in the right lung base. No pneumothorax or large effusion. The pulmonary vascularity is unremarkable. Calcification of the thoracic aorta.	Implanted Medical Device / left ; Opacity / lung / base / bilateral ; Calcinosis / aorta, thoracic ; Pulmonary Atelectasis / base / bilateral	1. Cardiac XXXX in stable position. 2. Increase in right and decrease in left basilar atelectasis.	OTHER;
Mediastinal contours are normal. Blunting of the left costophrenic XXXX. Increased interstitial opacities.. There is no pneumothorax or large pleural effusion.	Costophrenic Angle / left / blunted ; Opacity / lung / interstitial ; Lung Diseases, Interstitial / diffuse ; Pleural Effusion	Diffuse interstitial lung disease with pleural effusion.	Chest pain
The cardiomediastinal silhouette is normal in size and appearance. No pleural effusion or pneumothorax. Lungs are clear.	normal	Normal chest.	Dyspnea
Lung volumes are low. No focal infiltrates. Heart and pulmonary XXXX normal. An indwelling catheter from the left has its tip at the superior XXXX XXXX.	Lung / hypoinflation ; Catheters, Indwelling / left	Hypoinflation with no visible active cardiopulmonary disease.	Chemotherapy for AML.
The lungs are clear, and without focal air space opacity. The cardiomediastinal silhouette is normal in size and contour. There is no pneumothorax or large pleural effusion.	normal	No acute cardiopulmonary abnormality.	XXXX-year-old XXXX with XXXX.
The heart and lungs have XXXX XXXX in the interval. Both lungs are clear and expanded. Heart and mediastinum normal.	No Indexing	No active disease.	cxr for XXXX placement s/p calc fx and distal tibia fx
Heart size is within normal limits. No focal airspace consolidations. No pneumothorax or pleural effusion.	normal	No acute cardiopulmonary findings.	XXXX-year-old female with chest pain.
The heart and mediastinum are unremarkable. The lungs are clear without infiltrate. There is no effusion or pneumothorax.	normal	1. No acute cardiopulmonary disease.	XXXX-year-old with dyspnea on exertion.
The cardiac silhouette, upper mediastinum and pulmonary vasculature are within normal limits. There is no acute air space infiltrate, pleural effusion or pneumothorax.	normal	No acute process.	Back pain
There are low lung volumes. The lungs are clear. No focal airspace consolidation. No pleural effusion or pneumothorax. Heart size and mediastinal contour appear within normal limits.	Lung / hypoinflation	No acute abnormality demonstrated.	XXXX-year-old female with nausea. History of Hodgkin's lymphoma.
The Cardiopulmonary silhouette is normal. The Heart size is normal. The lungs are clear with no pulmonary effusions or pneumothorax.	normal	No acute cardiopulmonary findings.	XXXX-year-old with shortness of breath.
Heart size within normal limits. Right paratracheal prominence XXXX represents tortuous XXXX. XXXX lung volumes. Mild streaky bibasilar opacities. No pleural effusion or pneumothorax.	Mediastinum / right / paratracheal / prominent ; Opacity / lung / base / bilateral / streaky / mild ; Lung / hypoinflation ; Airspace Disease / lung / base / bilateral / streaky / mild ; Pulmonary Atelectasis	1. No evidence of pulmonary tuberculosis. 2. Low lung volumes with minimal streaky basilar airspace disease, XXXX atelectasis. 3. Right paratracheal prominence XXXX represents tortuous XXXX. Comparison with prior imaging studies could confirm this if available. .	XXXX-year-old woman screening for assisted living facility.
Borderline heart size. The lungs are hyperexpanded and hyperlucent compatible with chronic obstructive pulmonary disease. There are no XXXX focal air space consolidations. No pleural effusions or pneumothoraces. The hilar and mediastinal contours are unchanged. Aortic vascular calcifications. Normal pulmonary vascularity. Bone demineralization.	Cardiomegaly / borderline ; Lung / hyperdistention ; Lung, Hyperlucent ; Pulmonary Disease, Chronic Obstructive ; Calcinosis / aorta ; Bone Diseases, Metabolic	Findings of chronic obstructive pulmonary disease.	Seizure
The lungs are XXXX. XXXX opacities are present in the right costophrenic XXXX. No focal infiltrates. Heart size normal.	Opacity / costophrenic angle / right / multiple ; Pulmonary Disease, Chronic Obstructive ; Pulmonary Atelectasis / costophrenic angle / right / focal	Findings of COPD with right costophrenic XXXX focal atelectasis.	chest pain
Finding data is null	Surgical Instruments ; Pleural Effusion / left / moderate ; Bone Diseases, Metabolic ; Kyphosis / thoracic vertebrae ; Bone and Bones / degenerative ; Technical Quality of Image Unsatisfactory 	Sternotomy XXXX are noted in XXXX. Vascular clips are noted consistent with previous coronary artery bypass graft. The previously seen central venous line catheter has been removed. A left pleural effusion remains. Underlying atelectasis is suspected. Given differences in technique, the effusion is not XXXX to be significantly different but is XXXX favored to be lower end of moderate for size. Osseous structures are remarkable for osteopenia, degenerative changes and there is some kyphosis noted to the thoracic spine.	This is a XXXX-year-old female patient with history of coronary artery bypass graft x3 and recent open-heart surgery. Coronary artery bypass graft performed XXXX. The patient is an XXXX-XXXX.
The heart is normal in size. The mediastinum is within normal limits. Dual-lumen right IJ catheter is identified without pneumothorax. The lungs are moderately hypoinflated with bibasilar XXXX opacities XXXX adjacent atelectasis. There is ill-defined density overlying the anterior left 5th rib, possibly healing deformity versus superimposition of structures.	Catheters, Indwelling / right ; Lung / hypoinflation / moderate ; Opacity / lung / base / bilateral ; Pulmonary Atelectasis / base / bilateral ; Density / ribs / left / anterior	Moderate hypoinflation with associated bibasilar atelectasis.	INDICATION data is null
Cardiac and mediastinal silhouettes are normal. Pulmonary vasculature is normal. No pneumothorax or pleural effusion. No acute bony abnormality. XXXX XXXX opacities XXXX reflecting atelectasis versus bronchovascular crowding.	Opacity / lung / base / right ; Pulmonary Atelectasis / base / right ; Markings / lung / base / right / bronchovascular	Bronchovascular crowding versus atelectasis within the right lung base otherwise no acute cardiopulmonary disease.	Shortness of breath with productive XXXX
The cardiac silhouette is mildly enlarged and appears mildly increased in size from the XXXX study. There is normal caliber pulmonary vasculature. The lungs are grossly clear of focal airspace disease, pneumothorax, or pleural effusion. There is no evidence of pulmonary edema.	Cardiac Shadow / enlarged / mild ; Cardiomegaly / mild	Probable mild cardiomegaly, without evidence of acute failure. No focal airspace disease. .	Pain, history of end-stage renal disease, type 1 diabetes.
The heart is normal in size. The mediastinum is stable. Mild biapical scarring is identified. There is a nodular density in the right midlung which is stable from prior studies and noted to represent a granuloma on XXXX of XXXX. However, additional foci in the right upper lung are questioned. There is no acute infiltrate or pleural effusion.	Cicatrix / lung / apex / bilateral / mild ; Granuloma / lung / middle lobe / right ; Density / lung / upper lobe / right / round ; Density / lung / middle lobe / right / round	No acute disease. Vague right upper/mid lung nodular densities versus scarring and superimposed structures. CT may be warranted given patient's history.	Breast cancer, XXXX r/o XXXX
The lungs are clear. The heart and pulmonary XXXX are normal. Pleural spaces are clear. Mediastinal contours are normal.	normal	No acute cardiopulmonary disease	INDICATION: PAIN; coming to xray XXXX scan.
XXXX XXXX and lateral chest examination was obtained. The heart silhouette and mediastinal contours are not enlarged. Lungs demonstrate left lower lobe air space opacity with XXXX atelectasis without significant change. There is no effusion or pneumothorax.	Opacity / lung / lower lobe / left ; Pulmonary Atelectasis / lower lobe / left	1. Left lower lobe air space opacities without significant change.	Left rib fractures
The heart size is within normal limits. There is ectasia/tortuosity of the thoracic aorta. Calcified hilar lymph XXXX. Irregular calcific density projecting over the left lower lobe, stable since XXXX and may represent mitral annular calcifications. No focal airspace consolidation, pleural effusions or pneumothorax. Degenerative changes of the thoracic spine. No acute bony abnormalities.	Aorta, Thoracic / tortuous ; Calcinosis / lung / hilum / lymph nodes ; Density / lung / lower lobe / left / irregular ; Calcinosis / lung / lower lobe / left / irregular ; Thoracic Vertebrae / degenerative	No acute cardiopulmonary findings.	XXXX-year-old female with altered mental status
Stable appearance of the left axillary XXXX. No pneumothorax. The cardiomediastinal silhouette and vasculature are within normal limits for size and contour. The lungs are normally inflated and clear. Osseous structures are within normal limits for patient age.	No Indexing	1. Stable appearance of the left-sided XXXX without acute complicating features.	Post pacemaker implantation unable to raise left arm fully
The lungs are clear. There is hyperinflation of the lungs. There is no pleural effusion or pneumothorax. The heart and mediastinum are normal. mild arthritic changes of the spine are present.	Lung / hyperdistention ; Arthritis / spine / mild ; Pulmonary Disease, Chronic Obstructive	Hyperinflation consistent with COPD. No acute pulmonary disease identified.	Chest pain with shortness of breath
The lungs are clear. The cardiomediastinal silhouette is within normal limits. No pneumothorax or pleural effusion.	normal	Negative chest .	XXXX for one XXXX
The lungs are clear. Heart and pulmonary XXXX appear normal. The pleural spaces are clear and mediastinal contours are normal. Nodular density overlying the anterior left 4th rib XXXX represents a healing rib fracture.	normal	1. No acute cardiopulmonary disease	Preprocedure evaluation prior to bone marrow transplant
XXXX XXXX and lateral chest examination was obtained. The heart silhouette and mediastinal contours are not enlarged. Pacemaker leads are within the right atrium and ventricle. Lungs demonstrate there is right lower lobe airspace disease and small effusion suspicious for pneumonia. Left lung is clear. There is no pneumothorax.	Implanted Medical Device ; Airspace Disease / lung / lower lobe / right ; Pleural Effusion / right / small ; Pneumonia / lower lobe / right	1. Right lower lobe airspace disease and small effusion probably representing pneumonia.	Status post pacemaker implantation. XXXX.
Heart size is upper limits of normal. Aorta is tortuous. There is elevation of the left hemidiaphragm. There is a posterior basilar XXXX opacity seen on lateral XXXX XXXX representing subsegmental atelectasis, XXXX visualized on lateral view. No large pleural effusion or pneumothorax is identified. Scoliosis of the spine.	Aorta / tortuous ; Diaphragm / left / elevated ; Opacity / lung / base / posterior ; Pulmonary Atelectasis / base / posterior ; Scoliosis	1. Posterior basilar XXXX opacity XXXX representing subsegmental atelectasis. The lungs are otherwise clear.	Preoperative evaluation
Heart size, mediastinal contour, and pulmonary vasculature are within normal limits. Scattered granulomas and bilateral perihilar calcified lymph XXXX. Stable lingular scarring. No focal consolidation, large pleural effusion or pneumothorax is identified. No bony abnormality.	Granuloma / scattered / multiple ; Calcinosis / lung / hilum / lymph nodes / bilateral ; Cicatrix / lung / lingula ; Lung / bilateral / hyperdistention	1. No acute cardiopulmonary abnormality.	Preoperative lung transplant.
The heart size and mediastinal contours appear within normal limits. There are streaky left basilar opacities and blunting of the left costophrenic sulcus XXXX secondary to a small effusion. No pneumothorax. No acute bony abnormalities.	Opacity / lung / base / left / streaky ; Costophrenic Angle / sulcus / left / blunted ; Pleural Effusion / left / small ; Pulmonary Atelectasis / base / left	Small left pleural effusion with left basilar atelectasis.	XXXX-year-old female with C-section 5 days ago, XXXX
Lungs are clear without focal consolidation, effusion, or pneumothorax. Normal heart size. Bony thorax grossly unremarkable.	normal	Negative for acute cardiopulmonary abnormality.	XXXX-year-old male with mitomyopathy and tachycardia
There is a large hiatal hernia. The stomach is distended with an air-fluid level. This was incompletely demonstrated on the CT of the abdomen and pelvis. Heart is XXXX within normal limits. There is mild atelectatic change draped over the hernia sac. The lungs are otherwise grossly clear. There is no pneumothorax or pleural effusion. Heart size is XXXX within normal limits.	Hernia, Hiatal / large ; Pulmonary Atelectasis / mild	1. Large hiatal hernia with dilated intrathoracic stomach. This was incompletely evaluated on XXXX, however, radiographic and CT findings suggestive organoaxial gastric volvulus. A similar appearance was demonstrated on the XXXX exam and this is favored to represent a chronic finding. If clinically indicated, additional CT images through the mid to lower chest or upper XXXX XXXX be helpful for confirmation. 2. Otherwise, grossly clear lungs.	Intermittent abdominal pain.
Finding data is null	Lung / hyperdistention ; Implanted Medical Device / aortic valve ; Calcinosis / lung / hilum / lymph nodes / right ; Opacity / lung / lower lobe / right	Heart size normal. Over expanded lungs. Aortic valve prosthesis. Calcified right hilar lymph node. Stable peripheral right lower lobe opacities seen between the anterior 7th and 8th right ribs which may represent pleural reaction or small pulmonary nodules. The patient has XXXX right middle lobe atelectasis and scarring in this region on old CT scans. From XXXX.	History of Chronic XXXX and dyspnea
Normal heart size and mediastinal contours. Minimal blunting of the costophrenic XXXX. No focal airspace consolidation. No pneumothorax or pleural effusion.	Costophrenic Angle / bilateral / blunted / mild	No acute cardiopulmonary abnormality.	XXXX-year-old female, dyspnea.
Increased interstitial lung changes with superimposed pulmonary edema. Cardiomegaly. Negative for effusion or pneumothorax. Degenerative changes of the thoracic spine.	Pulmonary Edema ; Cardiomegaly ; Thoracic Vertebrae / degenerative	Cardiomegaly with pulmonary edema superimposed on chronic interstitial lung changes.	XXXX-year-old female with dyspnea.
The lungs are hyperinflated with mildly coarsened interstitial markings consistent with chronic lung disease. No focal consolidation, pneumothorax, or effusion identified. The mediastinal silhouette is stable and within normal limits for size. There is redemonstration without significant change in right hilar calcified lymph XXXX. The bony structures of the thorax demonstrate degenerative changes of the right shoulder and a XXXX right humerus consistent with distal humeral amputation. No acute bony abnormality identified.	Lung / hyperdistention ; Markings / lung / interstitial / mild ; Calcinosis / lung / hilum / lymph nodes / right ; Shoulder / right / degenerative	Changes of chronic lung disease without acute cardiopulmonary abnormality identified.	XXXX-year-old XXXX, XXXX, preop..
Normal heart size and mediastinal contours. Patchy right lower lobe airspace opacities. No pleural effusion or pneumothorax. Visualized osseous structures are unremarkable in appearance.	Opacity / lung / lower lobe / right / patchy ; Airspace Disease / lung / lower lobe / right / mild	Mild, nonconsolidating right lower lobe airspace disease. This may represent an early pneumonia.	Arterial female, shortness of breath, XXXX
The cardiac silhouette is enlarged and has a globular appearance. Mild bibasilar dependent atelectasis. No pneumothorax or large pleural effusion. No acute bone abnormality.	Cardiac Shadow / enlarged ; Pulmonary Atelectasis / base / bilateral / mild ; Cardiomegaly	Cardiomegaly with globular appearance of the cardiac silhouette. Considerations would include pericardial effusion or dilated cardiomyopathy.	XXXX-year-old woman with XXXX onset of chest pain
Finding data is null	Lung / hyperdistention ; Calcinosis / aorta ; Aorta / tortuous / mild ; Deformity / clavicle / left	Hyperinflated lungs with no focal alveolar consolidation. No definite pleural effusion seen. Heart size near top normal limits, aortic calcifications and mild ectasia/tortuosity. No typical findings of pulmonary edema. Contour irregularity of the left clavicle appears chronic and suggests old injury.	XXXX-year-old female, pain
Finding data is null	normal	Heart size is normal and lungs are clear. No pneumothorax, effusion, or pneumonia.	chest pain.
Cardiomegaly. There is no pulmonary edema. There is no focal consolidation. There are no XXXX of pleural effusion. There is no evidence of pneumothorax.	Cardiomegaly	Cardiomegaly similar to prior examination. Negative for evidence of acute pulmonary disease.	Preoperative evaluation
The lungs are clear, and without focal airspace opacity. The cardiomediastinal silhouette is enlarged. There is no pneumothorax or large pleural effusion.	Cardiac Shadow / enlarged ; Cardiomegaly	Cardiomegaly, but no focal consolidation.	XXXX-year-old XXXX with XXXX.
The heart is enlarged. There is pulmonary vascular congestion with diffusely increased interstitial and mild patchy airspace opacities. The distribution XXXX pulmonary edema. There is no pneumothorax or large pleural effusion. There are no acute bony findings.	Cardiomegaly ; Pulmonary Congestion ; Opacity / lung / interstitial / diffuse / patchy / mild ; Pulmonary Edema	Cardiomegaly with vascular congestion and suspected pulmonary edema. .	Dyspnea, generalized weakness.
The heart is normal size. The mediastinum is unremarkable. There is no pleural effusion, pneumothorax, or focal airspace disease. There is stable irregularity of the posterior left 6th rib which XXXX represents an old fracture..	Fractures, Bone / ribs / left / healed	No acute cardiopulmonary abnormality.	XXXX-year-old female with chest pain
The heart and lungs have XXXX XXXX in the interval. Both lungs are clear and expanded. Heart and mediastinum normal.	No Indexing	No active disease.	pt with XXXX, XXXX, wheezes and XXXX
The heart size is at the upper limits of normal. The mediastinum is unremarkable. There is no pleural effusion, pneumothorax, or focal airspace disease. Mild chronic degenerative changes are present within the thoracic spine..	Thoracic Vertebrae / degenerative / chronic / mild	No acute cardiopulmonary abnormality.	XXXX-year-old male with diabetic ketoacidosis and chest pain
The lungs are hyperinflated with biapical pleural-parenchymal scarring and upward retraction of the XXXX, similar to the prior study. There are multiple reticular-nodular opacities in the upper lobes bilaterally which appear grossly stable from the prior study. There is no evidence of XXXX, focal airspace disease. There is no pneumothorax or pleural effusion. Heart size is normal.	Lung / hyperdistention ; Cicatrix / lung / apex / bilateral ; Cicatrix / pleura / apex / bilateral ; Opacity / lung / upper lobe / bilateral / reticular / round / multiple / chronic ; Deformity / lung / hilum	Hyperinflation with chronic upper lobe reticular-nodular pleural-parenchymal opacities and hilar retraction. No gross interval change from XXXX. .	Lightheaded.
Finding data is null	Technical Quality of Image Unsatisfactory  ; Lung / hypoinflation / severe ; Cardiomegaly / mild ; Markings / bronchovascular / severe ; Pulmonary Congestion ; Infiltrate / lung / interstitial ; Kyphosis / severe ; Bone Diseases, Metabolic ; Catheters, Indwelling ; Pulmonary Edema / mild	Exam quality limited by very low lung volumes on the frontal view and rotation. Cardiomediastinal silhouette accentuated by technical factors, heart size XXXX mildly enlarged. Marked bronchovascular crowding, indistinct vascular margination may be secondary to crowding, mild pulmonary edema, interstitial infiltrates difficult to exclude. No definite pleural effusion seen. Osseous demineralization and exaggerated kyphosis, VP shunt tubing noted.	XXXX year old female, infection, XXXX
Finding data is null	Calcified Granuloma / lung / middle lobe / right ; Calcified Granuloma / lung / hilum / right	No evidence of tuberculosis. Heart size is normal. Lungs are clear. Calcified 5 mm right midlung granuloma and right hilar granulomas.	History of rheumatoid arthritis rule out tuberculosis before immunosuppression
Calcified granulomas. Calcified hilar XXXX. No focal areas of consolidation. Heart size within normal limits. No pleural effusions. No evidence of pneumothorax. Question large pulmonary arteries. Lung XXXX are hyperexpanded. Prominent substernal air space. Aortic calcifications. Degenerative changes thoracic spine.	Calcified Granuloma / multiple ; Calcinosis / lung / hilum ; Lung / hyperdistention ; Calcinosis / aorta ; Thoracic Vertebrae / degenerative ; Pulmonary Disease, Chronic Obstructive	Hyperexpanded lung XXXX compatible with COPD. No evidence of acute cardiopulmonary abnormality. .	XXXX-year-old female, chronic airway obstruction, history of COPD.
Compared to prior examination, XXXX stent has been removed. Cardiomediastinal silhouette is stable and within normal limits. Stable mild atherosclerotic calcifications of the aortic XXXX are noted. There are mildly low lung volumes without focal consolidation, pneumothorax, or effusion identified. No acute bony abnormality seen.	Atherosclerosis / aorta / mild ; Lung / hypoinflation / mild	Interval removal of XXXX stent without acute cardiopulmonary abnormality.	XXXX-year-old woman with wheezing and dyspnea..
Clear lungs. No pneumothorax. No pleural effusion. Normal heart. Mild degenerative changes of the thoracic spine without acute bony abnormality. Prominent right epicardial fat XXXX	Thoracic Vertebrae / degenerative / mild ; Epicardial Fat / right / prominent	No acute cardiopulmonary findings.	XXXX
The lungs are clear, and without focal air space opacity. The cardiomediastinal silhouette is normal in size and contour, and stable. There is no pneumothorax large pleural effusion.	normal	No acute cardiopulmonary abnormality.	XXXX-year-old woman with XXXX for 3 weeks.
Finding data is null	Hernia, Hiatal / prominent ; Opacity / lung / base / left ; Pleural Effusion / base / left ; Pulmonary Atelectasis / base / left ; Pleural Effusion / right	Prominent hiatal hernia. Left basilar opacity compatible pleural effusion and atelectasis. XXXX right pleural effusion. No pulmonary edema / overt CHF identified. Stable senescent mediastinal contour.	PAIN;
Normal heart and mediastinum. Clear lungs. Trachea is midline. No pneumothorax. No pleural effusion. Radiopaque foreign body overlying left chest.	Foreign Bodies / thorax / left	No acute abnormality.	XXXX-year-old with increasing dyspnea.
No focal consolidation. No visualized pneumothorax. No large pleural effusions. The heart size and cardiomediastinal silhouette is grossly unremarkable. There is motion artifact on the lateral radiograph.	Technical Quality of Image Unsatisfactory 	1. No acute cardiopulmonary findings.	XXXX-year-old with shortness of breath.
Finding data is null	Lung / hyperdistention	Lungs appear hyperinflated. This may be secondary to XXXX voluntary XXXX considering patient's age. Clear lungs. Mediastinal contour within normal limits. No acute cardiopulmonary abnormality identified.	786.2, 30yof with XXXX
PA and lateral views of the chest were obtained. The cardiomediastinal silhouette is normal in size and configuration. The lungs are well aerated. There is no pneumothorax, pleural effusion, or focal air space consolidation. Degenerative spine.	normal	1. No acute cardiopulmonary disease.	Knee pain, preop XXXX
Ribs are intact with no fractures or bone destruction. Both lungs remain clear and expanded. Heart and mediastinum are normal.	normal	1. Left and right ribs. Negative for fracture. 2. Chest. No evidence for cardiopulmonary injury.	AP, oblique left and right ribs. XXXX hours XXXX, XXXX.
The lungs are clear. There is no focal consolidation, pleural effusion, or pneumothorax. The Heart and mediastinum are normal size and shape. XXXX and soft tissues are unremarkable. Probable nerve stimulator noted.	Foreign Bodies	No Acute cardiopulmonary disease.	Chest pain
Normal heart size. No focal airspace consolidation, pneumothorax, pleural effusion, or pulmonary edema. No focal bony abnormality.	normal	No acute cardiopulmonary disease.	XXXX-year-old female with asthma and dyspnea.
Stable cardiomediastinal silhouette with normal heart size, mediastinal calcifications suggest a previous granulomatous process. Apical irregularities also present on the previous exam suggestive of scarring. No focal alveolar consolidation, no definite pleural effusion seen. No typical findings of pulmonary edema. No pneumothorax.	Calcinosis / mediastinum	No acute findings	XXXX-year-old male, pain
Heart size is normal. The lungs are clear. There are no XXXX focal air space consolidations. No pleural effusions or pneumothoraces. The hilar and mediastinal contours are unchanged. Again noted is tortuosity and unfolding of the thoracic aorta. Aortic vascular calcifications. Normal pulmonary vascularity. Bone demineralization.	Aorta, Thoracic / tortuous ; Calcinosis / aorta ; Bone Diseases, Metabolic	No acute abnormality.	XXXX-year-old XXXX for XXXX XXXX placement
Lung volumes are mildly low. The cardiomediastinal silhouette is within normal limits for size contour. No consolidation. No pleural effusion or pneumothorax. Mild degenerative disc change at the thoracic spine, no XXXX deformity.	Lung / hypoinflation / mild ; Thoracic Vertebrae / degenerative / mild	Low lung volumes, no acute cardiopulmonary findings.	Shortness of breath
Left-sided ICD is stable in position. XXXX XXXX sternotomy. There is stable cardiac enlargement. The lungs are clear. There are no focal air space consolidations. No pleural effusions or pneumothoraces. The hilar and mediastinal contours are normal. Calcified right hilar granuloma and right pulmonary granuloma. Normal pulmonary vascularity. No overt pulmonary edema.	Implanted Medical Device / left ; Cardiomegaly ; Calcified Granuloma / lung / hilum / right ; Granuloma / lung / right	Postoperative changes of the chest. Stable cardiomegaly.	Evaluate for chest masses
Heart size within normal limits. No focal alveolar consolidation, no definite pleural effusion seen. No typical findings of pulmonary edema.	normal	No acute cardiopulmonary findings	XXXX-year-old male, hypertension
Heart size, mediastinal contour, and pulmonary vascularity are within normal limits. No focal consolidation, large pleural effusion, or pneumothorax is identified. Minimal thoracic spondylosis.	Spondylosis / thoracic vertebrae / mild	No acute cardiopulmonary abnormality.	XXXX-year-old female with shortness of breath x 2 days
Lateral view, over the lingula, there is a 7mm diameter uncalcified nodule of uncertain origin. The trachea is midline. Negative for pneumothorax, pleural effusion or focal airspace consolidation. The heart size is normal. Mild tortuosity aorta is redemonstrated.	Nodule / lung / lingula ; Aorta / tortuous / mild	1. 7mm non calcified nodule, XXXX in appearance, recommend CT chest without contrast.	The patient is a XXXX-year-old female with history of tobacco use, chronic nonproductive XXXX.
Lungs are clear. No focal airspace consolidation or pleural effusion. Heart size is normal. No pneumothorax. Calcified lymph XXXX.	Calcinosis / lymph nodes	Clear lungs. No acute cardiopulmonary abnormality. .	XXXX XXXX female. Evaluate for metastatic disease
The heart is normal in size. The mediastinum is Stable. Calcified AP XXXX lymph XXXX are seen. A small right-sided pleural effusion versus thickening. Right inferior rib deformities.	Calcinosis / lymph nodes ; Pleural Effusion / right / small ; Thickening / pleura / right ; Deformity / ribs / right / multiple / healed ; Costophrenic Angle / right / blunted	Stable blunting of right costophrenic XXXX with small pleural effusion versus thickening and associated healed right rib deformities.	F/U AFTER SBRT FOR HCC;
There is no focal consolidation. Mild blunting of the posterior costophrenic XXXX XXXX represent small effusions. No pneumothorax is present. There is moderate cardiomegaly. The pulmonary vasculature is within normal limits.	Costophrenic Angle / posterior / blunted / mild ; Pleural Effusion / small ; Cardiomegaly / moderate	1. Unchanged cardiomegaly. 2. Question XXXX pleural effusions.	XXXX-year-old female for XXXX XXXX. History of asthma, congestive heart failure. Cardiac arrhythmia.
Normal heart size mediastinal contours. No focal airspace consolidation. No hyperexpansion of the lungs. No pleural effusion or pneumothorax.	normal	No acute cardiopulmonary abnormality.	The patient is a XXXX-year-old female with XXXX and XXXX. History of asthma.
Lungs are clear. No focal infiltrate. No pleural effusion or pneumothorax. Normal cardiomediastinal silhouette.	normal	No active disease.	Shortness of breath
The lungs and pleural spaces show no acute abnormality. Heart size is upper limits of normal, pulmonary vascularity within normal limits. .	normal	1. No acute pulmonary abnormality.	Pain with syncope. Blurry vision.
Frontal and lateral views of the chest show an unchanged cardiomediastinal silhouette. Reduced lung volumes with basilar atelectasis. No XXXX focal airspace consolidation or pleural effusion.	Lung / hypoinflation ; Pulmonary Atelectasis / base	No acute or active cardiac, pulmonary or pleural disease.	Chest pain shortness of breath for 3 days. The patient's lower abdomen was shielded for this exam.
The trachea is midline. Cardiomediastinal silhouette is normal and unchanged from prior examination. There are round calcific densities in the right lung consistent with prior granulomatous disease. Otherwise, the lungs are clear without evidence of acute infiltrate or effusion. There is no pneumothorax. The visualized bony structures reveal no acute abnormalities.	Density / lung / right / round / multiple ; Calcinosis / lung / right / round ; Granulomatous Disease	No acute cardiopulmonary abnormalities.	chest pain
Sequelae of old granulomatous disease. Lungs are overall hyperexpanded with flattening of the diaphragms. No focal consolidation. Prominent interstitial markings are again noted which are predominantly lower lobe and peripheral suggesting pulmonary fibrosis. This appearance is overall not significantly XXXX. No pleural effusions or pneumothoraces. heart and mediastinum are stable with atherosclerotic vascular disease. Degenerative changes in the thoracic spine.	Granulomatous Disease ; Lung / hyperdistention ; Diaphragm / flattened ; Markings / lung / lower lobe / interstitial / prominent ; Atherosclerosis ; Thoracic Vertebrae / degenerative	1. Overall stable appearance of the chest suggesting pulmonary fibrosis.	Recent XXXX loss.
Prominent interstitial markings in the lungs are unchanged. No focal infiltrates. Heart and pulmonary XXXX are normal.	Markings / lung / interstitial / prominent ; Lung Diseases, Interstitial / chronic / mild ; Cicatrix / lung	Chronic interstitial lung disease and scars unchanged. No acute disease.	pt with left sided chest pain, nonradiating. Pt with XXXX XXXX smoking histo
Heart size and cardiomediastinal contours are normal. Lungs are clear without focal airspace opacity, pleural effusion, or pneumothorax. No displaced rib fracture.	normal	Negative for acute cardiopulmonary findings.	XXXX-year-old male with XXXX and rib pain.
Right lower lobe patchy opacities noted. Heart size within normal limits. No pleural effusions. No evidence of pneumothorax. Mild degenerative changes of the thoracic spine.	Opacity / lung / lower lobe / right / patchy ; Thoracic Vertebrae / degenerative / mild ; Infiltrate / lung / lower lobe / right	Patchy right lower lobe opacities, XXXX infectious infiltrate.	XXXX-year-old female, XXXX, XXXX, chest pain.
Cardiomegaly with unfolded aorta. There is no pulmonary edema. There is no focal consolidation. There are no XXXX of a large pleural effusion. There is no evidence of pneumothorax.	Cardiomegaly ; Aorta / tortuous	Cardiomegaly. Clear lungs. .	Preoperative evaluation
There is chronic asymmetric elevation of the right hemidiaphragm. Compared with the prior study, there is mildly increased streaky airspace disease in the right lung base. Hilar prominence appears stable. There is no pneumothorax or large pleural effusion. Heart size is stable and grossly normal. There no acute bony findings.	Diaphragm / right / elevated / chronic ; Airspace Disease / lung / base / right / streaky ; Pulmonary Atelectasis / base / right	Chronic asymmetric elevation of the right hemidiaphragm with mildly increased right basilar airspace disease, atelectasis versus infiltrate. .	Shortness of breath.
There is an marked interval increase in heart size. The heart also demonstrates the XXXX XXXX configuration, compatible with pericardial effusion. A small right pleural effusion the present. The lungs are otherwise clear without focal infiltrates. Normal pulmonary vascularity. No pneumothorax.	Cardiomegaly ; Pericardial Effusion / large ; Pleural Effusion / right / small	Large pericardial effusion.	History of pericardial effusion.
The cardiomediastinal silhouette and pulmonary vasculature are within normal limits. There is no pneumothorax or pleural effusion. There are no focal areas of consolidation. Cholecystectomy clips are present. Small T-spine osteophytes. There is biapical pleural thickening, unchanged from prior. Mildly hyperexpanded lungs.	Osteophyte / thoracic vertebrae / multiple / small ; Thickening / pleura / apex / bilateral ; Lung / hyperdistention / mild	No acute cardiopulmonary abnormality.	Chest and nasal congestion.
The lungs are hyperexpanded consistent with emphysema. Pectus carinatum is noted. The heart size and pulmonary vascularity appear within normal limits. The lungs are free of focal airspace disease. Calcified granuloma are noted. Vascular calcification is noted.	Lung / hyperdistention ; Pulmonary Emphysema ; Pectus Carinatum ; Calcified Granuloma ; Calcinosis / blood vessels	1. Hyperexpanded lungs consistent with emphysema. 2. Pectus carinatum. 3. No evidence of acute disease.	XXXX.
Heart size and mediastinal contour within normal limits. No focal airspace consolidation, pneumothorax, or large pleural effusion. No acute osseous abnormality.	normal	No acute cardiopulmonary abnormality.	XXXX
The heart and lungs have XXXX XXXX in the interval. Both lungs are clear and expanded. Heart and mediastinum normal.	No Indexing	No active disease.	XXXX, XXXX, htn with elevation
The lungs are clear bilaterally. Specifically, no evidence of focal consolidation, pneumothorax, or pleural effusion.. Multiple calcified granulomas identified bilaterally. Cardio mediastinal silhouette is unremarkable. Visualized osseous structures of the thorax are without acute abnormality.	Calcified Granuloma / bilateral / multiple	No acute cardiopulmonary abnormality.	XXXX-year-old male XXXX with chronic XXXX, wheeze, tachycardia..
Finding data is null	normal	Heart size is normal and lungs are clear. No pneumonia.	chills and XXXX XXXX
Both lungs are clear and expanded. Heart and mediastinum normal. Surgical clips are in the epigastrium of the abdomen.	Surgical Instruments / abdomen	No active disease.	XXXX LOSS
The heart size and mediastinal silhouette are within normal limits for contour. The lungs are clear. No pneumothorax or pleural effusions. The XXXX are intact.	normal	No acute cardiopulmonary abnormalities.	XXXX-year-old male with shortness of breath.
There is blunting of the left costophrenic XXXX compatible with a moderate to large left pleural fluid collection. There are areas of airspace opacity within the left lung base which may represent atelectasis or infiltrate. Minimal bandlike atelectasis within the right lung base. Heart size is normal. Left-sided tunneled catheter terminates at the caval atrial junction. Right IJ venous catheter terminates at the proximal SVC.	Costophrenic Angle / left / blunted ; Pleural Effusion / left / large ; Opacity / lung / base / left ; Pulmonary Atelectasis / base / right / mild ; Catheters, Indwelling / bilateral ; Pulmonary Atelectasis / left ; Airspace Disease / lung / left	Lines and tubes as above. Moderate-to-large left pleural effusion, with adjacent airspace disease or atelectasis.	XXXX-XXXX placement. PICC placement.
Finding data is null	Markings / bronchovascular	Heart size within normal limits. No focal alveolar consolidation, no definite pleural effusions seen. Bronchovascular crowding without typical findings of pulmonary edema.	XXXX-year-old female, XXXX bleed
Small 3.3 mm right-sided pneumothorax only visible on the left lateral decubitus film. Left lung is clear. Normal cardiac contour. No evidence of pleural effusion.	Pneumothorax / right / small	1. Small 3.3 mm right-sided pneumothorax.	XXXX-year-old male for rule out pneumothorax.
Heart size is normal. Lungs are clear. No pneumothorax or pleural effusion.	normal	No acute cardiopulmonary findings.	Chest pressure. No known XXXX.
Normal heart size. No focal air space consolidation, pneumothorax, pleural effusion, or pulmonary edema. No focal bony abnormality.	normal	No acute cardiopulmonary disease.	46 are old female with dyspnea.
Lungs are clear. No pleural effusions or pneumothoraces. Heart and mediastinum of normal size and contour.	normal	Clear lungs.	cp
The heart and cardiomediastinal silhouette are normal in size and contour. There is no focal air space opacity, pleural effusion, or pneumothorax. There are multilevel degenerative changes in the thoracic spine.	Thoracic Vertebrae / degenerative / multiple	No acute cardiopulmonary finding.	XXXX-year-old male with recent right deltoid and proximal arm biopsy.
Heart size is at the upper limits of normal. There is aortic atherosclerotic vascular calcification. The lungs remain hyperexpanded. There are biapical opacities, stable from the prior study. No XXXX focal airspace consolidation. No significant pleural effusion. No pneumothorax. There are mild degenerative changes of the spine.	Atherosclerosis / aorta ; Lung / hyperdistention ; Opacity / lung / apex / bilateral ; Spine / degenerative / mild ; Emphysema	1. No focal airspace consolidation. 2. Emphysema. 3. Stable biapical opacities, possibly scarring.	XXXX-year-old male, preoperative evaluation for heart valve repair.
Heart size and pulmonary vascularity appear within normal limits. The lungs are free of focal airspace disease. No pleural effusion or pneumothorax is seen. There is mild prominence of the interstitial markings which are unchanged.	Markings / lung / interstitial / prominent / mild	1. No evidence of acute disease.	XXXX, congestion and sore throat.
The lungs are clear, and without focal air space opacity. The cardiomediastinal silhouette is normal in size and contour, and stable. There is no pneumothorax or large pleural effusion.	normal	No acute cardiopulmonary abnormality.	43 rolled male with dyspnea.
Calcified granulomas are noted within the lung bases and stable compared with prior study. The cardiac silhouette and mediastinal contours are within normal limits. There is no pneumothorax. There is no focal opacity. No large pleural effusion. XXXX is minimal retrolisthesis of two lower thoracic vertebral bodies.	Calcified Granuloma / lung / base / bilateral ; Dislocations / thoracic vertebrae	No acute cardiopulmonary disease. Retrolisthesis of two lower thoracic vertebral bodies.	Dyspnea.
Finding data is null	Cardiomegaly ; Hernia, Hiatal / large	Stable cardiomegaly with large hiatal hernia. The lungs are clear	History of dyspnea.
Cardiac and mediastinal contours are within normal limits. Atherosclerotic aorta. Mild blunting left costophrenic recess, possibly mild atelectasis or scarring. No confluent lobar consolidation or large volume pleural effusion. Thoracic spondylosis.	Atherosclerosis / aorta ; Costophrenic Angle / left / blunted / mild ; Spondylosis / thoracic vertebrae	Mild blunting left costophrenic recess, possibly mild atelectasis or scarring.	Preop lumbar spine surgery
No pneumothorax, pleural effusion or airspace consolidation. Heart size and pulmonary vasculature appear within normal limits. XXXX XXXX are intact.	normal	No acute cardiopulmonary abnormality. No evidence of active tuberculosis. .	The patient is a XXXX-year-old male with positive PPD. History of BCG vaccination.
Artifact in the region of the central upper abdomen. No focal areas of consolidation. No pleural effusions. No evidence of pneumothorax. Heart size within normal limits. Osseous structures intact.	Foreign Bodies / abdomen ; Technical Quality of Image Unsatisfactory 	Limited exam secondary to artifact within the upper abdomen (this does not represent free intra-abdominal XXXX). Recommend repeat chest x-XXXX.	XXXX-year-old male, chest pain.
The heart is top normal in size. The mediastinum is stable. The aorta is atherosclerotic. XXXX opacities are noted in the lung bases compatible with scarring or atelectasis. There is no acute infiltrate or pleural effusion.	Atherosclerosis / aorta ; Opacity / lung / base / bilateral ; Cicatrix / lung / base / bilateral ; Pulmonary Atelectasis / base / bilateral	Chronic changes without acute disease.	Dyspnea
Streaky and patchy bibasilar opacities, triangular density projected over the heart on the lateral view. No definite pleural effusion seen, no typical findings of pulmonary edema. Considering differences in technical factors XXXX stable cardiomediastinal silhouette with normal heart size.	Opacity / lung / base / bilateral / patchy / streaky ; Technical Quality of Image Unsatisfactory 	Bibasilar opacities, right greater than left, features suggest a combination of consolidation and atelectasis	XXXX-year-old female, COPD exacerbation, short of breath
AP and lateral views were obtained. Bibasilar atelectasis and small left-sided pleural effusion. Stable cardiomegaly. No pneumothorax. Mild pulmonary vascular congestion.	Pulmonary Atelectasis / base / bilateral ; Pleural Effusion / left / small ; Cardiomegaly ; Pulmonary Congestion / mild	Impression data is null	Dyspnea seen impression
Finding data is null	Aorta / tortuous ; Ribs / prominent	Heart size is normal. Lungs are clear. Tortuous aorta. Prominent first ribs. No nodules, masses, or adenopathy.	History XXXX with rhonchi bone pain and nosebleed.
Stable cardiomediastinal silhouette with tortuous thoracic aorta. No pneumothorax, pleural effusion or suspicious focal air space opacity. Stable right lung base scarring.	Aorta, Thoracic / tortuous ; Cicatrix / lung / base / right	Stable exam with no acute abnormality seen.	Chest and midback pain.
A patchy infiltrate has developed in the right middle lobe. Left lung is clear. Heart size normal. Aorta tortuous.	Infiltrate / lung / middle lobe / right / patchy ; Pneumonia / middle lobe / right ; Aorta / tortuous	Right middle lobe infiltrate consistent with pneumonia.	XXXX
The lungs are clear. There is no pleural effusion. The heart and mediastinum are normal as are the skeletal structures and soft tissues.	normal	No active disease.	XXXX.
The lungs appear clear. There are calcified nodules projecting in the right upper lung. Mediastinal contours appear normal. The heart pulmonary XXXX appear normal. Pleural spaces are clear. Surgical clips are identified in the right neck and left mediastinum.	Calcinosis / lung / upper lobe / right ; Nodule / lung / upper lobe / right ; Surgical Instruments / mediastinum / left ; Surgical Instruments / neck / right	No acute cardiopulmonary disease.	MALIGNANT NEOPLASM OF THYROID GLAND
The lungs and pleural spaces show no acute abnormality. Lungs are mildly hyperexpanded. Heart size and pulmonary vascularity within normal limits.	Lung / hyperdistention / mild	1. No acute pulmonary abnormality.	Productive XXXX
There is a left-sided PICC with tip at the caval atrial junction. The cardiomediastinal contours are within normal limits. Pulmonary vasculature is unremarkable. There is no focal airspace opacity. No pleural effusion or pneumothorax is seen. Stable short segment catheter tubing overlying the left XXXX, XXXX to reside within anterior chest soft tissues on recent chest CT. Stable remote posttraumatic changes of multiple right ribs.	Catheters, Indwelling ; Deformity / ribs / right / multiple	1. Left PICC tip at cavoatrial junction. 2. No acute cardiopulmonary abnormality.	XXXX
The heart is normal in size. The mediastinum is within normal limits. Pectus deformity is noted. Left IJ dual-lumen catheter is visualized without pneumothorax. The lungs are clear.	Deformity / thorax ; Catheters, Indwelling / left	No acute disease.	Kidney transplant evaluation
The heart, pulmonary XXXX and mediastinum are within normal limits. There is no pleural effusion or pneumothorax. There is no focal air space opacity to suggest a pneumonia. There are mild degenerative changes of the spine.	Spine / degenerative / mild	No acute cardiopulmonary disease.	XXXX-year-old with XXXX. Pain with breathing that started last XXXX.
Lungs are clear bilaterally with no focal infiltrate, pleural effusion, or pneumothoraces. Cardiomediastinal silhouette is within normal limits. XXXX and soft tissues are unremarkable.	normal	No acute cardiopulmonary findings. .	XXXX-year-old female with XXXX, chest pain
Flattening of the bilateral hemidiaphragms. Lungs are clear. Soft tissues and bony structures unremarkable. No pneumothorax or effusion.	Diaphragm / bilateral / flattened ; Lung / hyperdistention / mild	Mild hyperexpansion. No acute process.	SOB
Finding data is null	Density / lung / base / right / mild	Heart size and mediastinal contour are normal. Pulmonary vascularity is normal. Subtle airspace density within the medial right lung base, not obscuring the right heart XXXX. This may represent focal right lower lobe pneumonia given history. Left lung clear. No effusions. No pneumothorax. Skeletal structures unremarkable.	XXXX on the congestion, XXXX for 2 days
Finding data is null	Calcified Granuloma / lung / lingula / small ; Pulmonary Atelectasis / middle lobe ; Infiltrate / lung / middle lobe	Heart size is normal. Left midlung small calcified granulomas unchanged. Persistent partial middle lobe atelectasis and infiltrate seen XXXX on the lateral	History of dyspnea.
Cardiomegaly is present. This is unchanged. There is mild prominence of the pulmonary vascularity which is unchanged. No XXXX focal airspace disease is seen. No pleural effusion or pneumothorax is identified.	Cardiomegaly ; Pulmonary Congestion / mild	1. Cardiomegaly with mild vascular prominence. No change.	Hypertension.
The heart is not enlarged. The central pulmonary vasculature is not engorged. Visualized osseous structures are unremarkable. No pneumothorax or pleural effusion. Small right juxtahilar opacity may represent infiltrate. Lungs are otherwise well aerated.	Opacity / lung / hilum / right / small	Small right juxtahilar opacity may represent infiltrate in the setting of XXXX. Followup chest x-XXXX is recommended at an appropriate interval following treatment to document XXXX.	XXXX, smoking.
Finding data is null	Scoliosis / severe ; Tube, Inserted / trachea ; Catheters, Indwelling / left ; Opacity / retrocardiac ; Pulmonary Atelectasis ; Thorax / left / small ; Markings / bronchovascular ; Tube, Inserted / right ; Catheters, Indwelling	XXXX displacement of a fusion XXXX on the lateral view with distal tip closely approximating the skin surface with a change in alignment since the previous exam. Severe scoliosis, tracheostomy tube, left PICC tip in the right hemithorax in the expected location of the right subclavian vein, repositioning recommended. Heart size within normal limits for technique, retrocardiac opacity XXXX due at XXXX in part to atelectasis with small left hemithorax, bronchovascular crowding without typical findings of pulmonary edema. VP shunt tubing and right nephrostomy tube.	XXXX-year-old male, evaluate heart or placement
Heart size, mediastinal contour, and pulmonary vascularity are within normal limits. No focal consolidation, suspicious pulmonary opacity, large pleural effusion, or pneumothorax is identified. Spondylosis of the midthoracic spine with large anterior osteophyte formations.	Spondylosis / thoracic vertebrae ; Osteophyte / thoracic vertebrae / anterior / multiple / large	No acute cardiopulmonary abnormality.	XXXX-year-old female, preop evaluation
Low lung volumes. Heart size and mediastinal contour within normal limits. No focal air space consolidation, pneumothorax, or pleural effusion. Mild thoracic spine degenerative change.	Lung / hypoinflation ; Thoracic Vertebrae / degenerative / mild	No acute cardiopulmonary abnormality.	XXXX and congestion
The heart size and pulmonary vascularity appear within normal limits. The lungs are free of focal airspace disease. No pleural effusion or pneumothorax is seen. Calcified granuloma is present in the right lung base. Bibasilar bandlike opacities are present. The appearance XXXX scarring or atelectasis.	Calcified Granuloma / lung / base / right ; Opacity / lung / base / bilateral / multiple ; Cicatrix / lung / base / bilateral ; Pulmonary Atelectasis / base / bilateral ; Granulomatous Disease	1. Evidence of previous granulomatous infection. 2. Bibasilar bandlike opacities. The appearance XXXX atelectasis/scar.	Bone marrow transplant evaluation.
The heart size and mediastinal contours appear within normal limits. Atherosclerotic calcification of the aorta. No focal airspace consolidation, pleural effusions or pneumothorax. Questionable thin-walled cavitary lesion in the right lower lobe, only seen on the AP view and may represent artifact. No acute bony abnormalities.	Atherosclerosis / aorta	1. No acute cardiopulmonary findings.	XXXX-year-old female with hypertension
Cardiac and mediastinal contours are unremarkable. Pulmonary vascularity is within normal limits. No focal air space opacities, pleural effusion, or pneumothorax. No cavitary lesions. XXXX are grossly unremarkable.	normal	1. Clear lungs. No radiographic evidence of active TB.	XXXX-year-old female with positive PPD
The heart size is upper limits of normal. The pulmonary XXXX and mediastinum are within normal limits. There is no pleural effusion or pneumothorax. There is no focal air space opacity to suggest a pneumonia.	normal	No acute cardiopulmonary disease.	XXXX-year-old with preop evaluation for bariatric surgery.
Finding data is null	Calcinosis / aorta ; Catheters, Indwelling / right ; Pleural Effusion / bilateral / small ; Pulmonary Atelectasis / base / bilateral ; Opacity / lung / hilum / streaky ; Pulmonary Congestion ; Pulmonary Edema ; Opacity / lung / bilateral / scattered / round / multiple	Stable normal heart size. Calcified aorta. Right chest XXXX in the SVC. Small volume bilateral pleural effusions basilar atelectasis. Streaky perihilar opacification, XXXX a component of vascular congestion in central pulmonary edema persist. Nodular opacities scattered throughout the lungs compatible with known pulmonary parenchymal metastatic disease. Similar appearance to the prior study.	CHF
No focal consolidation. No visualized pneumothorax. The heart size is normal. There are no large pleural effusions.	normal	1. No acute cardiopulmonary findings.	XXXX-year-old with shortness of breath.
There is a right IJ central venous catheter with tip overlying the inferior SVC. Cardiac silhouette is normal size. Normal mediastinal contour and pulmonary vasculature. There is a small right pleural effusion. Otherwise, lungs are without focal airspace disease.	Catheters, Indwelling ; Pleural Effusion / right / small	XXXX XXXX right pleural effusion.	XXXX-year-old male with HIV and syphilis on hemodialysis now with XXXX.
Stable left-sided ICD and postsurgical changes consistent with prior CABG. The cardiomediastinal silhouette and vasculature are within normal limits for size and contour. The lungs are normally inflated and clear. Mild degenerative endplate changes of the spine.	Implanted Medical Device / left ; Spine / degenerative	1. No acute radiographic cardiopulmonary process.	Pain and difficulty breathing
The cardiomediastinal silhouette and vasculature are within normal limits for size and contour. The lungs are normally inflated and clear. Mild degenerative changes of the spine.	Spine / degenerative / mild	1. No acute radiographic cardiopulmonary process.	Left-sided chest pain for 1-1/2 weeks for
No acute osseous abnormalities. Mild thoracic spine degenerative changes. Soft tissues are within normal limits. No focal area of consolidation, pleural effusion, or pneumothorax.	Thoracic Vertebrae / degenerative / mild	1. No finding suggestive of active disease.	XXXX-year-old XXXX with positive PPD
The heart is normal in size. The mediastinum is unremarkable. There are XXXX opacities in both lung bases compatible with scarring or atelectasis. Calcified granuloma in the left upper lung is noted as well as right retrocardiac calcified nodule. No significant pleural effusion is seen.	Opacity / lung / base / bilateral / mild ; Pulmonary Atelectasis / base / bilateral ; Cicatrix / lung / base / bilateral ; Calcified Granuloma / lung / upper lobe / left ; Nodule / right / retrocardiac ; Calcinosis / right / retrocardiac	Mild XXXX XXXX opacities with scarring; no acute disease.	EVALUATE FOR METASTATIC DISEASE;
Right chest XXXX tip low SVC. Cardiac and mediastinal contours are within normal limits. The lungs are clear. Prosthetic right humeral head. Prior lower cervical spine surgery. XXXX deformity at the thoracolumbar junction with an acute kyphosis.	Catheters, Indwelling / right ; Implanted Medical Device / humerus / right ; Deformity / thoracic vertebrae ; Deformity / lumbar vertebrae ; Kyphosis / thoracic vertebrae ; Kyphosis / lumbar vertebrae	No acute pulmonary findings.	XXXX and cardiomyopathy
Chest: The heart size and cardiomediastinal silhouette are normal. The lungs are clear without focal airspace opacity, pleural effusion, or pneumothorax. The osseous structures are intact. Left knee: There is no fracture-dislocation. There are degenerative changes with medial compartment osteophytes. There is no suprapatellar effusion. There is a XXXX.	normal	Chest: No acute cardiopulmonary finding. Left knee: Minimal degenerative changes, however no acute bony abnormality.	XXXX-year-old with edema and chronic knee pain.
Cardiomediastinal contours are unchanged. There are stable fractures of several XXXX XXXX. Lungs are hyperexpanded but clear. No pneumothorax or pleural effusion. Degenerative changes are seen in the spine.	Fractures, Bone ; Lung / hyperdistention ; Spine / degenerative	No acute cardiopulmonary process. .	Pain and shortness of breath.
The lungs are clear. There is no focal consolidation, pleural effusion, or pneumothorax. The Heart and mediastinum are normal size and shape. XXXX and soft tissues are unremarkable.	normal	No Acute cardiopulmonary disease.	Chest pain
The trachea is midline. The heart XXXX is large, unchanged from prior exam. Slightly widened mediastinum, secondary to cardiomegaly and a tortuous aorta, is accentuated by AP portable technique. There are low lung volumes causing bibasilar atelectasis and bronchovascular crowding. The lungs do not demonstrate focal infiltrate or effusion. There is no pneumothorax. The visualized bony structures reveal no acute abnormalities.	Cardiomegaly ; Mediastinum / prominent / mild ; Aorta / tortuous ; Lung / hypoinflation ; Pulmonary Atelectasis / base / bilateral ; Markings / bilateral / bronchovascular	1. Low volume study without acute cardiopulmonary abnormalities. .	The patient is a XXXX-year-old woman with dyspnea.
Cardiomediastinal silhouette is within normal limits of size and appearance. The pulmonary vascularity is unremarkable. Lungs are expanded and clear of airspace disease. Negative for pneumothorax or pleural effusion. Limited bone evaluation reveals no acute abnormality. There is incompletely evaluated lumbar levoscoliosis.	normal	No acute cardiopulmonary abnormality.	XXXX, dyspnea
There are no focal areas of consolidation. No pleural effusions. No pneumothorax. Heart size within normal limits. Osseous structures intact.	normal	No acute cardiopulmonary abnormality.	XXXX-year-old female, dizziness.
XXXX XXXX and lateral chest examination was obtained. The heart silhouette is normal in size and contour. Aortic XXXX appear unremarkable. Lungs demonstrate no acute findings. There is no effusion or pneumothorax. Bilateral prominent lung vascularity medially, unchanged.	Pulmonary Congestion / bilateral	1. No acute pulmonary disease.	Chest pain.
The heart, pulmonary XXXX and mediastinum are within normal limits. There is no pleural effusion or pneumothorax. There is no focal air space opacity to suggest a pneumonia. There is an interim XXXX cervical spinal fusion partly evaluated.	normal	No acute cardiopulmonary disease.	XXXX-year-old with XXXX on XXXX. Dyspnea. History of mitral valve prolapse.
The heart is normal in size and contour. There is no mediastinal widening. Low lung volumes. No focal airspace disease. No large pleural effusion or pneumothorax. The XXXX are intact.	Lung / hypoinflation	No acute cardiopulmonary abnormalities.	Weakness.
Trachea is midline. The cardiomediastinal silhouette is normal. The lungs are clear without evidence of acute infiltrate or effusion. There is no pneumothorax. The visualized bony structures reveal no acute abnormality.	normal	No acute cardiopulmonary abnormality.	dyspnea
Lungs are clear bilaterally. There is no focal consolidation, pleural effusion, or pneumothoraces. Cardiomediastinal silhouette is within normal limits. XXXX are unremarkable.	normal	No acute cardiopulmonary abnormality.	Actinomyces Healing Wound
Hyperinflated lungs with flattened diaphragm and increased retrosternal airspace. Scattered chronic appearing irregular interstitial markings with no focal alveolar consolidation, no definite pleural effusion seen. No typical findings of pulmonary edema.	Lung / hyperdistention ; Diaphragm / bilateral / flattened ; Markings / lung / interstitial / scattered / irregular / chronic	Hyperinflated lungs, air trapping versus inspiratory XXXX.	XXXX-year-old male, XXXX
The heart is normal in size. The mediastinum is unremarkable. The lungs are clear.	normal	No acute disease.	XXXX BMT W/U;
Finding data is null	Opacity / lung / base / left / streaky / mild ; Pulmonary Atelectasis / base / left ; Infiltrate / lung / base / left	Stable cardiomediastinal silhouette with normal heart size. XXXX mild streaky opacities in the left base, atelectasis versus infiltrate. No definite pleural effusion seen. No typical findings of pulmonary edema.	XXXX-year-old female, chest pain
There is stable cardiomegaly. The mediastinum is unremarkable. Atherosclerotic calcifications are present within the thoracic aorta. There is no pleural effusion, pneumothorax, or focal airspace disease. Chronic degenerative changes are present in the thoracic spine.	Cardiomegaly ; Atherosclerosis / aorta, thoracic ; Thoracic Vertebrae / degenerative / chronic	1. Stable cardiomegaly without acute cardiopulmonary abnormality.	XXXX-year-old female with shortness of breath
The lungs are clear. No pleural effusion or pneumothorax is identified. The heart and mediastinum are normal. The skeletal structures and soft tissues are normal.	normal	No active disease.	XXXX and asthma shortness of breath.
The cardiac silhouette is mildly enlarged. A lobulated opacity is identified superior to the heart, in the anterior mediastinum on the lateral view, possibly consistent with a tortuous/ectatic thoracic aorta versus an anterior mediastinal mass. The thoracic aorta is tortuous and calcified. No focal areas of pulmonary consolidation. The lungs are hyperexpanded with flattening of the bilateral hemidiaphragms. No pneumothorax or pleural effusion. Severe degenerative changes of the thoracic spine.	Cardiac Shadow / enlarged / mild ; Opacity / supracardiac ; Aorta, Thoracic / tortuous ; Calcinosis / aorta, thoracic ; Lung / hyperdistention ; Diaphragm / bilateral / flattened ; Thoracic Vertebrae / degenerative / severe ; Cardiomegaly / mild ; Pulmonary Disease, Chronic Obstructive	1. Lobulated anterior mediastinal opacity on the lateral view, possibly consistent with a tortuous/ectatic thoracic aorta versus an anterior mediastinal mass. Contrast-enhanced XXXX examination would XXXX to further evaluate if clinically indicated. 2. Mild cardiomegaly with findings of chronic obstructive pulmonary disease.	XXXX-year-old female with shortness of breath.
No focal consolidation, pneumothorax, or large pleural effusion identified. Stable blunting of the right costophrenic XXXX XXXX due to pleural thickening/sclerosis. Redemonstration and stable appearance of bilateral calcified granulomas/lymph XXXX. Changes in the lungs consistent with COPD/emphysema. Cardiomediastinal silhouette stable and unremarkable. No acute osseous abnormalities identified. Opacity in the left apex consistent with radiation change seen on prior CT.	Costophrenic Angle / right / blunted ; Thickening / pleura / right ; Sclerosis / pleura / right ; Calcified Granuloma / lung / bilateral / multiple ; Calcinosis / lung / lymph nodes / bilateral / multiple ; Pulmonary Disease, Chronic Obstructive ; Pulmonary Emphysema ; Opacity / lung / apex / left	1. No acute cardiopulmonary process identified. Specifically, no radiographic evidence of aspiration. 2. Stable emphysematous changes, right costophrenic XXXX pleural thickening, and bilateral calcified granulomas/lymph XXXX.	XXXX-year-old male with possible aspiration..
The heart is normal in size. The mediastinum is within normal limits. Small calcified lymph XXXX are seen. The lungs are clear.	Calcinosis / lymph nodes / small	No acute disease.	Left-sided chest pain and shortness of breath
There is prominence of the left hilum which may represent adenopathy or engorged vasculature. Cardiac silhouette is within normal limits of size and contour. No pneumothorax or large pleural effusion. No acute bone abnormality.	Lung / hilum / left / prominent	Prominence of the left hilum may be secondary to adenopathy or enlarged pulmonary vasculature. Chest CT with contrast may be helpful for further clarification.	XXXX-year-old female, chest pain.
Heart size within normal limits. No alveolar consolidation, no findings of pleural effusion or pulmonary edema. No pneumothorax.	normal	No acute cardiopulmonary findings	XXXX-year-old male, XXXX, XXXX of breath
Lungs are clear without focal consolidation, effusion, or pneumothorax. Hyperexpanded lungs. Normal heart size. Bony thorax and soft tissues grossly unremarkable.	Lung / hyperdistention ; Emphysema / mild	Mild emphysema. Negative for acute cardiopulmonary abnormality.	XXXX-year-old female with dyspnea
The cardiomediastinal silhouette and pulmonary vasculature are within normal limits. There is no pneumothorax or pleural effusion. There are no focal areas of consolidation. There are T-spine osteophytes. XXXX calcified granuloma in the right apex.	Osteophyte / thoracic vertebrae / multiple ; Calcified Granuloma / lung / apex / right	No acute cardiopulmonary abnormality.	Chronic XXXX
Frontal and lateral views of the chest show normal size and configuration of the cardiac silhouette. Normal pulmonary vasculature and central airways. No focal airspace consolidation or pleural effusion.	normal	No acute or active cardiac, pulmonary or pleural disease.	Syncope. Chest and abdominal pain.
The lungs and pleural spaces show no acute abnormality. Heart size and pulmonary vascularity within normal limits. .	normal	1. No acute pulmonary abnormality.	Stabbing right upper abdominal pain
The XXXX examination consists of frontal and lateral radiographs of the chest. The cardiomediastinal contours are within normal limits. Pulmonary vascularity is within normal limits. There is a vague right suprahilar density with elevation of the XXXX fissure most XXXX mild subsegmental atelectasis though superimposed infection cannot be entirely excluded. The remaining lungs are clear. The visualized osseous structures and upper abdomen are unremarkable.	Density / lung / hilum / right ; Pulmonary Atelectasis / upper lobe / right / mild	Right upper lobe subsegmental atelectasis. No evidence of heart failure.	Peripheral edema.
Low lung volumes noted. The heart size is within normal limits. Pulmonary vasculature is unremarkable. No focal consolidations, effusions, or pneumothoraces.	Lung / hypoinflation	Low lung volumes without acute cardiopulmonary abnormality.	XXXX-year-old female with chest pain
The heart is normal in size and contour. There is no mediastinal widening. The lungs are clear bilaterally. No large pleural effusion or pneumothorax. Fractures of the posterior left 4th, 5th, and 6th ribs, age-indeterminate.	Fractures, Bone / ribs / left / posterior / multiple	1. No acute cardiopulmonary abnormalities. Specifically, no pneumothorax. 2. Fractures of the posterior left 4th, 5th, and 6th ribs, age-indeterminate.	Chest pain. Concern for pneumothorax.
Both lungs are clear and expanded. Heart and mediastinum normal.	normal	No active disease.	wheezing and XXXX
There are scattered XXXX opacities in the left lower lobe. Cardiac silhouette is within normal limits. There is prominence of the right and left hilum XXXX representing enlargement of the central pulmonary arteries. No pneumothorax or pleural effusion. No acute bone abnormality.	Opacity / lung / lower lobe / left / scattered / multiple ; Lung / hilum / bilateral / prominent ; Pulmonary Artery / bilateral / enlarged ; Pneumonia / lower lobe / left	1. Left lower lobe opacities XXXX representing pneumonia. 2. Enlargement of the central pulmonary arteries raising the question of pulmonary hypertension.	XXXX-year-old female, chest pain.
There are midline sternotomy XXXX and mediastinal clips consistent with prior CABG. The heart is enlarged with unfolding of the aorta. There is prominence of the interstitial markings with fluid in the fissures consistent with interstitial edema. There is no focal airspace opacity, large pleural effusion, or pneumothorax. There multilevel degenerative spine changes.	Surgical Instruments / mediastinum ; Cardiomegaly ; Aorta / tortuous ; Markings / lung / interstitial / prominent ; Pulmonary Edema / interstitial ; Spine / degenerative / multiple	1. Interstitial pulmonary edema. 2. Cardiomegaly.	XXXX-year-old male with chest pain.
The trachea is midline. The cardiomediastinal silhouette is normal. There are small round calcific density nodules consistent with prior granulomatous disease bilaterally. Otherwise, the lungs are clear without evidence of acute infiltrate or effusion. There are no masses seen. There is no pneumothorax. The visualized bony structures reveal no acute abnormalities.	Granulomatous Disease ; Nodule / lung / bilateral / round / multiple / small ; Density / lung / bilateral / round / multiple / small ; Calcinosis / lung / bilateral / round / multiple / small	No acute cardiopulmonary abnormalities.	XXXX h/o sarcoma.
A calcified granuloma is present in the right costophrenic XXXX. Lungs are otherwise clear. Heart size normal.	Calcified Granuloma / costophrenic angle / right	No active disease.	dyspnea
There are XXXX sternotomy XXXX identified. The heart is within normal limits in size. The aorta is calcified and tortuous. There are scattered calcified granulomas throughout both lungs. No focal infiltrate, pleural effusion, or pneumothorax. Mild degenerative changes of the thoracic spine.	Calcinosis / aorta ; Aorta / tortuous ; Calcified Granuloma / lung / bilateral / scattered / multiple ; Thoracic Vertebrae / degenerative / mild	1. Stable appearance of the chest. No acute process.	XXXX year old hypertension and chest pain.
There is hyperinflation of the lungs. A small area scarring is seen in the left cardiophrenic XXXX region. There is no pleural effusion or pneumothorax. The heart is not significantly enlarged. There are atherosclerotic changes of the aorta. Arthritic changes of the skeletal structures are noted.	Lung / hyperdistention ; Cicatrix / cardiophrenic angle / left / small ; Atherosclerosis / aorta ; Arthritis ; Pulmonary Atelectasis ; Cicatrix / lung / base / left / small ; Pulmonary Disease, Chronic Obstructive	COPD and small left basilar scar.	Lightheaded and dizzy. Hypertension.
Low lung volumes. Heart size normal. No pneumothorax, pleural effusion, or focal airspace disease. Bony structures appear intact. Left humeral head bone anchors.	Lung / hypoinflation ; Implanted Medical Device / humerus / left	No acute cardiopulmonary abnormality.	XXXX-year-old female with XXXX onset of XXXX.
Finding data is null	Opacity / lung / hilum / pulmonary alveoli / left ; Opacity / lung / hilum / left / interstitial	Interstitial and alveolar opacities most confluent in the left perihilar lung may be compatible with infection, differential diagnosis includes atypical pulmonary edema, inflammation. No definite pleural effusion seen. Stable cardiomediastinal silhouette with near top normal heart size. Aeration of the left perihilar lung may be slightly improved compared with the XXXX image from XXXX.	XXXX-year-old male, pain, XXXX
Lung volumes remain XXXX. XXXX opacity is present in the right middle lobe. No focal infiltrates. Heart size normal.	Opacity / lung / middle lobe / right ; Lung / hypoinflation ; Pulmonary Atelectasis / middle lobe / right / focal	Continued hypoinflation with right middle lobe focal atelectasis.	chronic XXXX
Normal heart size and mediastinal contours. Low lung volumes mild bibasilar atelectasis. No focal airspace consolidation. No pleural effusion or pneumothorax. Visualized osseous structures are unremarkable in appearance. The lateral views are limited by patient positioning and motion. Large cervical spine osteophytes.	Lung / hypoinflation ; Pulmonary Atelectasis / base / bilateral / mild ; Technical Quality of Image Unsatisfactory  ; Osteophyte / cervical vertebrae / multiple / large	1. No acute cardiopulmonary abnormality. 2. Technically limited exam. 3. Incidental note XXXX of large cervical spine osteophytes. .	XXXX-year-old male, XXXX, XXXX XXXX ladder 6 feet.
The heart size is upper limits of normal. The pulmonary XXXX and mediastinum are within normal limits. There is no pleural effusion or pneumothorax. There is no focal air space opacity to suggest a pneumonia.	normal	No acute cardiopulmonary disease.	XXXX-year-old with nausea and vomiting XXXX eating. Pain and the breast bone that radiates into the abdomen. Shortness of breath. Nonsmoker.
Heart size within normal limits, stable mediastinal and hilar contours. No focal alveolar consolidation, no definite pleural effusion seen. No typical findings of pulmonary edema.	normal	No acute findings	XXXX-year-old female, XXXX
Finding data is null	Scoliosis / thoracic vertebrae / right / mild ; Cardiomegaly / mild ; Lung / blood vessels / left / prominent / mild ; Lung / azygos lobe	2 views of the chest demonstrate sternotomy XXXX and mild thoracic dextroscoliosis. Incidental note of an azygos pseudofissure. The heart is mildly enlarged and pulmonary vasculature appears somewhat more prominent on the left than on the right, but the lungs appear clear, with no evidence of pleural effusion.	TOF
Finding data is null	normal	Heart size normal. Lungs clear.	anemia.
Heart size and mediastinal contours are stable. Atherosclerotic calcifications of the aorta. Moderate severe hyperexpansion of the lungs and decreased peripheral vascular markings, consistent with emphysema. Stable biapical pleural-parenchymal scarring. Scattered granulomas. No abnormal airspace consolidation. No pneumothorax or pleural effusion.	Atherosclerosis / aorta ; Lung / hyperdistention / severe ; Emphysema ; Cicatrix / lung / apex / bilateral ; Cicatrix / pleura / apex / bilateral ; Granuloma / scattered / multiple	1. Stable emphysematous changes. 2. Stable biapical pleural-parenchymal scarring.	XXXX-year-old male, dyspnea
Bilateral glenohumeral degenerative joint disease. Scattered degenerative changes of the thoracic spine. Stable mild heart enlargement.Prominence of soft tissue density in the upper mediastinum. It is increased from most recent prior exam on XXXX. However, it appears similar compared to XXXX exams performed in XXXX. No focal area of consolidation, pleural effusion, or pneumothorax. Focal opacity in the left upper lobe XXXX represents scarring or related to overlying rib opacity.	Humerus / bilateral / degenerative ; Thoracic Vertebrae / scattered / degenerative ; Cardiomegaly / mild ; Density / mediastinum / prominent ; Opacity / lung / upper lobe / left / focal ; Cicatrix / lung / upper lobe / left ; Opacity / ribs / left	1. No acute cardiopulmonary abnormality. 2. Prominent soft tissue density in the upper mediastinum. Recommend follow PA and lateral radiograph XXXX XXXX or CT thorax for further evaluation.	XXXX-year-old XXXX with chest pain and shortness of breath
The heart is normal in size and contour. The lungs are clear, without evidence of infiltrate. There is no pneumothorax or effusion. There is an obliquely oriented XXXX lucency through the posterior right 12th rib.	Lucency / ribs / right / posterior	Acute obliquely oriented lucency through the right 12th posterior rib, concerning for acute fracture. Recommend correlation with side of XXXX tenderness. No other fractures are XXXX identified. If there is high clinical concern, recommend further evaluation with dedicated views of the right ribs.	XXXX year old kicked in the right lower side by a XXXX.
Finding data is null	normal	Heart size is normal and the lungs are clear.	tuberculosis positive PPD
The mediastinal and hilar lymph XXXX are less prominent than previously. Heart size remains normal. Lungs are clear.	Lung / hilum / lymph nodes / bilateral / enlarged ; Mediastinum / lymph nodes / bilateral / enlarged	Decreasing bilateral hilar adenopathy. Continued clear lungs.	Sarcoidosis, XXXX CXR
Finding data is null	Cardiomegaly / borderline ; Pulmonary Congestion ; Pulmonary Atelectasis / base ; Pleural Effusion / posterior	Borderline cardiac enlargement. Vascular congestion without overt pulmonary edema. Basilar atelectasis with XXXX posterior recess pleural effusions. Overall, findings of mild volume overload.	Difficulty breathing
Both lungs are clear and expanded. Heart and mediastinum normal.	normal	No active disease.	High blood pressure.
Pacemaker generator overlying the left chest in stable position with 2 leads terminating in the right atrium and right ventricle in stable position. Stable XXXX sternotomy XXXX. No pneumothorax, pleural effusion, or focal airspace disease. Minimal fluid within the right horizontal fissure.	Implanted Medical Device / left	Stable pacemaker generator within the left chest with 2 distal leads terminating in the right atrium and right ventricle, also in stable position. No pneumothorax.	XXXX-year-old female status post pacemaker placement
The heart size is normal. The mediastinal contour is within normal limits. There are multiple calcified granulomas within the left lower lobe. The lungs are free of any focal infiltrates. There are no nodules or masses. No visible pneumothorax. No visible pleural fluid. The XXXX are grossly normal. There is no visible free intraperitoneal air under the diaphragm.	Calcified Granuloma / lung / lower lobe / left / multiple	No acute radiographic cardiopulmonary process.	XXXX-year-old female with COPD and left pleuritic chest pain.
Heart size mildly enlarged with enlarged right atrium. No focal alveolar consolidation, no definite pleural effusion seen. No pneumothorax.	Cardiomegaly / mild ; Heart Atria / right / enlarged	Cardiomegaly, no acute pulmonary findings	XXXX-year-old male, pain
Finding data is null	Cardiac Shadow / enlarged / moderate ; Infiltrate / lung / base / right / patchy / mild ; Pulmonary Atelectasis / base / right / mild ; Cicatrix / lung / lingula ; Pulmonary Atelectasis / lingula	Moderate enlargement of the heart XXXX. This shows significant interval increase in size from the remote XXXX comparison. XXXX cardiomegaly or pericardial fluid could have this appearance. Minimal patchy infiltrate/atelectasis in medial right base and lingular scarring or subsegmental atelectasis. No pleural effusion or pneumothorax.	Dyspnea, leg XXXX, cellulitis.
There are low lung volumes with bibasilar opacities XXXX representing subsegmental atelectasis. The cardio the cardiac silhouette is of the XXXX of normal. There is no pneumothorax or pleural effusion.	Lung / hypoinflation ; Opacity / lung / base / bilateral / streaky ; Pulmonary Atelectasis / base / bilateral	Low lung volumes with bibasilar streaky opacities most XXXX representing subsegmental atelectasis.	XXXX x4 weeks.
The trachea is midline. The cardiomediastinal silhouette is normal. Low lung volumes causing mild bronchovascular crowding. No focal airspace consolidation is seen. There is no pleural effusion. There is no large pneumothorax. Visualized bony structures reveal no acute abnormalities. Pression: Low lung volumes without acute cardiopulmonary findings. .	Lung / hypoinflation ; Markings / bronchovascular / mild	Impression data is null	The patient is a XXXX-year-old XXXX with a history of asthma and XXXX.
Finding data is null	Pneumothorax ; Pleural Effusion / small ; Tube, Inserted / abdomen ; Surgical Instruments / abdomen ; Foreign Bodies / lumbar vertebrae	Persistent 8mm pneumothorax with small amount of pleural effusion. Heart size normal. Enteric tube tip in the stomach. Midline abdominal clips. XXXX in the right upper quadrant. Bullet overlies L3.	followup pneumothorax
The heart is normal in size and contour. There is no mediastinal widening. The lungs are hyperexpanded. No focal airspace disease. No large pleural effusion or pneumothorax. Exaggerated kyphosis.	Lung / hyperdistention ; Kyphosis / severe	No acute cardiopulmonary abnormalities.	Dyspnea.
Finding data is null	Aorta / tortuous / mild ; Calcinosis / aorta / mild	Heart size normal. Slightly tortuous calcified aorta. No pneumothorax or effusion. No evidence of aortic transection.	History of XXXX vehicle collision
The lungs are clear bilaterally. Specifically, no evidence of focal consolidation, pneumothorax, or pleural effusion. Cardiomediastinal silhouette is unremarkable. Visualized osseous structures of the thorax are without acute abnormality.	normal	No acute cardiopulmonary abnormality.	XXXX-year-old woman, XXXX vehicle collision.
The heart is mild enlarged. Central pulmonary vascularity is again accentuated. There are also mild increased interstitial markings without focal consolidation or pleural effusion.	Cardiomegaly / mild ; Pulmonary Congestion / mild ; Markings / lung / interstitial / mild ; Pulmonary Edema	Mild stable cardiomegaly with mild central pulmonary vascular congestion and interstitial accentuation, XXXX edema.	Dyspnea
The heart size is normal. No pneumothorax. No large pleural effusions. No focal airspace opacities.	No Indexing	No acute cardiopulmonary abnormalities. .	XXXX-year-old female with XXXX and syncope
The heart is normal in size. The mediastinum is unremarkable. The lungs are clear.	normal	No acute disease.	Bilateral breast cancer
Cardiac and mediastinal XXXX appear normal. No visible pneumothorax, focal airspace opacity, or pleural effusion is seen. No visible free air under the diaphragm. The osseous structures appear intact. There is a mild dextro scoliotic curvature of the midthoracic spine.	Scoliosis / thoracic vertebrae / right / mild	No acute radiographic cardiopulmonary process. .	XXXX-year-old male, MVC.
The cardiomediastinal silhouette and pulmonary vasculature are within normal limits. There is no pneumothorax or pleural effusion. There are no focal areas of consolidation. Cholecystectomy clips are present.	Surgical Instruments / abdomen	No acute cardiopulmonary abnormality.	XXXX
The heart size and pulmonary vascularity appear within normal limits. The lungs are free of focal airspace disease. No pleural effusion or pneumothorax is seen.	normal	No evidence of active disease.	Nausea, vomiting, preop for surgery
The lungs are clear. Heart size is normal. No pneumothorax. There are endplate changes within the spine.	Spine / degenerative	Clear lungs. No acute cardiopulmonary abnormality. .	INDICATION data is null
Lungs are clear bilaterally. There is no focal consolidation, pleural effusion, or pneumothoraces. There is widening adjacent to the right paratracheal stripe, most XXXX represents the SVC with rotated position. XXXX are unremarkable.	Mediastinum / right / paratracheal / enlarged ; Technical Quality of Image Unsatisfactory 	No acute cardiopulmonary abnormality.	XXXX medicine screening
Mediastinal contours are normal. Unchanged XXXX opacity in the left lung base, XXXX scarring. Lungs are clear. There is no pneumothorax or large pleural effusion.	Opacity / lung / base / left ; Cicatrix / lung / base / left	No acute cardiopulmonary abnormality.	Chest pain
The cardiac contours are normal. The lungs are clear. Thoracic spondylosis.	Spondylosis / thoracic vertebrae	No evidence of active pulmonary pneumonia on today's exam.	Pneumonia one XXXX ago, worsening clinical symptoms.
The cardiomediastinal silhouette is normal in size and contour. No focal consolidation, pneumothorax or large pleural effusion. Normal XXXX.	normal	Negative for acute abnormality.	XXXX-year-old female. Chest pain.
Heart size is normal. No pneumothorax or pleural effusions. There is an 8 mm calcified nodule in the left midlung. There is also a 7 mm calcified nodule near the left hilum. Hyperexpanded lungs consistent with chronic obstructive pulmonary disease.	Calcinosis / lung / lingula ; Nodule / lung / lingula ; Calcinosis / lung / hilum / left ; Nodule / lung / hilum / left ; Lung / hyperdistention ; Pulmonary Disease, Chronic Obstructive	No acute cardiopulmonary findings.	XXXX-year-old female, rule out mass or TB.
Cardiac and mediastinal contours are within normal limits. Prior granulomatous disease. The lungs are clear. Bony structures are intact.	Granulomatous Disease	No acute findings.	XXXX.
Finding data is null	Lung / obscured ; Opacity / lung / base / left ; Pleural Effusion / left ; Pulmonary Atelectasis / base / left ; Technical Quality of Image Unsatisfactory 	Pulmonary detail obscured secondary to body habitus and superimposed soft tissue. Again seen is a left basilar opacity compatible with some effusion and adjacent left basilar atelectasis. Overall, size of effusion appears slightly smaller. Right lung stable and grossly clear. No XXXX acute abnormalities since the previous chest radiograph.	HYPERTENSION;
The postoperative cardiomediastinal silhouette is stable and upper limits of normal in size. There are XXXX sternotomy XXXX and surgical clips compatible with prior CABG. There is at XXXX one left-sided coronary artery stent. Pulmonary vasculature is normal in caliber. The lungs are grossly clear of focal airspace disease, pneumothorax, or pleural effusion. There are no acute bony findings.	Surgical Instruments / mediastinum ; Stents / coronary vessels / left	No acute findings. .	Chest pain and shortness of breath.
Finding data is null	normal	Heart size is normal and lungs are clear. Right aortic XXXX with probable aberrant left subclavian artery. This is a normal variant seen in one of 200 patients. No evidence of tuberculosis	chest.
Clear lungs. Normal heart. No pneumothorax. No pleural effusion. Old right rib fractures.	normal	No acute cardiopulmonary abnormality.	XXXX-year-old with dyspnea.
The heart and lungs have XXXX XXXX in the interval. Both lungs are free of acute infiltrates and expanded. Strandy scarring in the left lower lobe is unchanged. Heart and mediastinum normal.	Cicatrix / lung / lower lobe / left / streaky	No active disease.	Vomiting.
Heart size and vascularity normal. These contour normal. Lungs clear. No pleural effusions or pneumothoraces.	normal	Normal chest.	Positive TB test
The lungs are clear bilaterally. Specifically, no evidence of focal consolidation, pneumothorax, or pleural effusion.. Cardio mediastinal silhouette is unremarkable. Visualized osseous structures of the thorax are without acute abnormality.	normal	No acute cardiopulmonary abnormality..	XXXX-year-old female with productive XXXX and chest pain..
The heart and cardiomediastinal silhouette or normal in size and contour. There is no focal air space opacity, pleural effusion, or pneumothorax. The osseous structures are intact.	normal	No acute cardiopulmonary finding.	XXXX-year-old male with history of prolonged intubation and XXXX XXXX anesthesia induction.
Finding data is null	Cardiomegaly / mild ; Pleural Effusion / right ; Infiltrate / lung / lower lobe / right ; Hydropneumothorax / right	Left lung clear. Slight cardiomegaly. Right effusion. Right lower lobe infiltrate. Two air-fluid levels in the right hemithorax most XXXX representing hydropneumothorax. This radiographic finding could also represent empyema with a bronchopleural fistula. CT scan with IV contrast may be helpful.	followup consolidation mass. Brain metastasis versus abscess.
The heart is normal in size. The mediastinum is unremarkable. The lungs are hypoinflated but grossly clear.	Lung / hypoinflation	No acute disease.	Chest pain
The cardiomediastinal silhouette is normal in size and contour. No focal consolidation, pneumothorax or large pleural effusion. Normal XXXX.	normal	Negative for acute abnormality.	XXXX-year-old male. Pain. XXXX.
PA and lateral views of the chest were obtained. Tracheostomy tube. Probable mild cardiomegaly. Prominence of the central vasculature, unchanged. No pneumothorax pleural effusion or focal consolidation.	Tube, Inserted / trachea ; Cardiomegaly / mild ; Pulmonary Congestion	1. No acute cardiopulmonary disease. 2. Stable mild cardiomegaly. 3. Prominent central vasculature.	Preop. Bariatric surgery
Bilateral pleural effusions, left small, right moderate in size, abnormal opacities in the adjacent lung bases. Limited assessment of heart size due to obscured margins, stable mediastinal contours.	Pleural Effusion / left / small ; Pleural Effusion / right / moderate ; Opacity / lung / base / bilateral ; Technical Quality of Image Unsatisfactory 	1. Bilateral pleural effusions, right larger than left 2. Abnormal pulmonary opacities which may be due to atelectasis, differential diagnosis includes infection, aspiration, atypical distribution pulmonary edema	XXXX-year-old female, short of breath, pain
Heart size and mediastinal contour are normal. Pulmonary vascularity is normal. Lungs are clear. No pleural effusions or pneumothoraces.	normal	No acute cardiopulmonary process.	XXXX XXXX steps, left posterior rib pain
The cardiomediastinal silhouette is within normal limits for appearance. The trachea is midline. No focal pulmonary consolidation. No pneumothorax. No pleural effusion. Minimal degenerative changes of the thoracic spine.	Thoracic Vertebrae / degenerative / mild	1. No acute cardiopulmonary process. .	XXXX year old male with XXXX.
The lungs are clear bilaterally. Specifically, no evidence of focal consolidation, pneumothorax, or pleural effusion.. Cardio mediastinal silhouette is unremarkable. Visualized osseous structures of the thorax are without acute abnormality.	normal	No acute cardiopulmonary abnormality..	XXXX-year-old male with hypertension..
The heart is normal in size. Mild fullness of the left hilum, small interval change from prior exam. Lucencies throughout the chest XXXX representing emphysematous change. Scattered bilateral calcified granulomas. No pneumothorax. Large hiatal hernia, increased from prior exam.	Lung / hilum / left / prominent / mild ; Lucency / thorax / scattered / multiple ; Emphysema ; Calcified Granuloma / bilateral / scattered / multiple ; Hernia, Hiatal / large	1. Increased left hilar fullness. This may represent superimposed XXXX, adenopathy cannot be excluded on this exam. If there is clinical concern, suggest reference to prior exam or CT chest. 2. Large hiatal hernia, increased in size from prior exam.	Dyspnea
Lungs are clear bilaterally. Cardiac and mediastinal silhouettes are normal. Pulmonary vasculature is normal. No pneumothorax or pleural effusion. No acute bony abnormality.	normal	No acute cardiopulmonary abnormality.	Shortness of breath, wheezing, XXXX.
Lungs are clear. There is no pneumothorax or pleural effusion. The heart and mediastinum are within normal limits. Bony structures are intact.	normal	No acute cardiopulmonary process.	History of immunodeficiency syndrome with shortness of breath
The cardiac silhouette and mediastinal contours are within normal limits. There is no focal opacity. There is no pneumothorax. There is no large pleural effusion.	normal	No acute cardiopulmonary disease.	XXXX.
Right chest central venous line is noted with tip in the mid SVC. There is no pneumothorax. Heart size is normal. No large pleural effusions. No acute focal airspace opacification.	Catheters, Indwelling / right	No acute cardiopulmonary abnormalities. .	XXXX-year-old female with XXXX
The heart is normal in size with normal appearance of the cardiomediastinal silhouette. The lungs are clear without focal airspace opacity, pleural effusion, or pneumothorax. The osseous structures are intact, with mild degenerative changes in the thoracic spine.	Thoracic Vertebrae / degenerative / mild	No acute cardiopulmonary finding.	XXXX-year-old female with congestion.
XXXX XXXX and lateral chest examination was obtained. The heart silhouette and mediastinal contours are not enlarged. Lungs demonstrate no acute findings. There is no effusion or pneumothorax.	normal	1. No acute pulmonary disease.	Intermittent asthma. Productive XXXX.
Intact XXXX sternotomy XXXX and CABG markers. Calcified granulomas. Heart size is normal. No focal airspace consolidation, suspicious pulmonary opacity, pneumothorax, or pleural effusion. T-spine degenerative changes.	Calcified Granuloma / multiple ; Thoracic Vertebrae / degenerative	Postsurgical changes of CABG without acute cardiopulmonary abnormality.	Altered mental status
The cardiomediastinal silhouette is within normal limits for appearance. The thoracic aorta is mildly tortuous and calcified. No focal areas of pulmonary consolidation. No pneumothorax. No pleural effusion. Mild degenerative changes of the thoracic spine. Mild levoscoliosis of the thoracolumbar spine.	Aorta, Thoracic / tortuous / mild ; Calcinosis / aorta, thoracic / mild ; Thoracic Vertebrae / degenerative / mild ; Scoliosis / lumbar vertebrae / left / mild ; Scoliosis / thoracic vertebrae / left / mild	1. No acute intrathoracic abnormality.	XXXX-year-old female with chest pain.
Bilateral patchy pulmonary opacities noted. Interval improvement in left base consolidative opacity. Pulmonary vascular congestion again noted. Stable enlarged cardiomediastinal silhouette. Stable left XXXX. No evidence of pneumothorax. No large pleural effusions.	Opacity / lung / base / bilateral / scattered / focal / patchy / multiple ; Pulmonary Atelectasis ; Consolidation / lung / base / left ; Pulmonary Congestion ; Cardiac Shadow / enlarged	1. Interval improvement in consolidative left base opacity. Multifocal scattered bibasilar patchy and XXXX pulmonary opacities again noted, most consistent with atelectasis/infiltrate. 2. Stable enlarged cardiomediastinal silhouette. Stable pulmonary vascular congestion. .	XXXX-year-old male, shortness of breath.
Finding data is null	normal	Heart size normal and lungs clear.	chronic XXXX.
Lungs are clear bilaterally. There is no focal consolidation, pleural effusion, or pneumothoraces. Cardiomediastinal silhouette is within normal limits. XXXX are unremarkable.	normal	No acute cardiopulmonary abnormality.	Chest pain, dyspnea
The lungs are clear. Heart size and mediastinal contours are normal. No osseous abnormalities.	normal	Impression data is null	XXXX-year-old female with XXXX for one XXXX
Patient is status post CABG. The heart size and pulmonary vascularity appear within normal limits. The lungs are free of focal airspace disease. No pleural effusion or pneumothorax is seen. Calcified granuloma is noted.	Calcified Granuloma	No evidence of active disease.	Bladder cancer
XXXX sternotomy XXXX are intact and unchanged position from prior exam. Lungs are clear bilaterally with no focal infiltrate, pleural effusion, or pneumothoraces. Cardiomediastinal silhouette is within normal limits. XXXX and soft tissues are unremarkable.	No Indexing	1. Unremarkable examination of the chest..	XXXX-year-old male with tetralogy of Fallot
Finding data is null	Calcinosis / lung / base / right / small ; Granulomatous Disease ; Calcinosis / lung / hilum / lymph nodes / small	Small calcification right lung base with appearance of old granulomatous disease. Also small perihilar calcified lymph XXXX. Lungs are clear. No active parenchymal disease. No XXXX of pleural effusions. No pulmonary edema. Normal heart size. No XXXX of active cardiopulmonary disease. Unchanged.	Sarcoid Hx sarcoidosis; Occasional XXXX/SOB; No cp/previous injury/surgery; Non-XXXX.
Heart size is normal. There is tortuosity of the thoracic aorta, stable compared with prior. No focal airspace disease or effusion. No pleural effusions or pneumothoraces. Degenerative changes in the thoracic spine.	Aorta, Thoracic / tortuous ; Thoracic Vertebrae / degenerative	No acute cardiopulmonary process.	XXXX, preop for abdominal aortic aneurysm repair
There are low lung volumes. There is bronchovascular crowding. Heart and mediastinal contours within normal limits. No focal infiltrate or effusion. No pneumothorax. Visualized osseous structures intact.	Lung / hypoinflation ; Markings / bronchovascular	No acute abnormality. Low volumes XXXX XXXX for the opportunity to assist in the care of your patient. If there are any questions about this examination please XXXX. XXXX XXXX, XXXX certified radiologist, at XXXX. .	XXXX-year-old female with XXXX
The heart is normal in size. The mediastinum is unremarkable. The lungs are clear.	normal	No acute disease.	pt states pain couple of days worse today
Lungs are clear. There is minimal atelectasis in the left base. No effusion or pneumothorax. Heart and mediastinal contours within normal limits. XXXX density foreign body present in the soft tissues overlying the left lateral chest wall. Visualized osseous structures intact.	Pulmonary Atelectasis / base / left / mild ; Foreign Bodies / thorax / left ; Density / thorax / left	Minimal atelectasis left base, no acute abnormality.	The left lateral rib pain, XXXX, gunshot wound 40 years ago
Frontal and lateral views of the chest with overlying external cardiac monitor leads show normal size and configuration of the cardiac silhouette. Normal pulmonary vasculature and central airways. No focal airspace consolidation or pleural effusion.	Medical Device	No acute or active cardiac, pulmonary or pleural disease.	Chest pain and weakness.
The heart size and pulmonary vascularity appear within normal limits. The lungs are free of focal airspace disease. No pleural effusion or pneumothorax is seen. Large hiatal hernia is present. Osteopenia and degenerative changes are present in the spine. Vascular calcification is noted. Degenerative changes are present in the right shoulder.	Hernia, Hiatal / large ; Bone Diseases, Metabolic / spine ; Spine / degenerative ; Calcinosis / blood vessels ; Shoulder / right / degenerative	1. Large hiatal hernia. 2. Clear lungs.	XXXX loss.
Heart size, mediastinal contour, and pulmonary vascularity are within normal limits. Minimal streaky atelectasis the left lung base. No focal consolidation, suspicious pulmonary opacity, large pleural effusion, or pneumothorax is identified. Thoracic spondylosis.	Pulmonary Atelectasis / base / left / streaky / mild ; Spondylosis / thoracic vertebrae	No acute cardiopulmonary abnormality.	XXXX-year-old male with XXXX onset XXXX XXXX/XXXX
Frontal and lateral views of the chest with overlying external cardiac monitor leads show an unchanged cardiomediastinal silhouette. No XXXX focal airspace consolidation or pleural effusion.	Medical Device	No acute or active cardiac, pulmonary or pleural disease.	Dyspnea. Shortness of breath. Extremity numbness.
The cardiac contours are normal. XXXX scarring left base. The lungs are clear. Thoracic spondylosis.	Cicatrix / lung / base / left ; Spondylosis / thoracic vertebrae	No acute preoperative process.	Preop anesthesia XXXX for temporal cancer.
The heart is normal in size. The pulmonary vascularity is within normal limits in appearance. No focal air space opacities. No pleural effusions or pneumothorax. No acute bony abnormalities.	normal	No acute cardiopulmonary abnormalities.	Chest pain.
XXXX XXXX and lateral chest examination was obtained. The heart silhouette and mediastinal contours are not enlarged. Cardiac pacemaker leads are within right atrium and ventricle. There is stable XXXX tube. Lungs demonstrate left lower lobe of he states he may be atelectasis or pneumonia. There is small left-sided effusion. No pneumothorax.	Implanted Medical Device / right ; Tube, Inserted ; Pleural Effusion / left / small ; Pulmonary Atelectasis / lower lobe / left ; Pneumonia / lower lobe / left	1. Left lower lobe atelectasis or pneumonia with small pleural effusion.	Followup pneumonia
Finding data is null	normal	No active disease.	TB INACTIVE V12.01
Normal cardiac contour. Right sided pleural effusion. Clear left lung XXXX. No pneumothorax.	Pleural Effusion / right	1. Right sided pleural effusion.	XXXX-year-old male status post MVC.
The heart and lungs have XXXX XXXX in the interval. Both lungs are clear and expanded. Heart and mediastinum normal. Note XXXX of placement of a retention XXXX in the lower cervical spine.	Implanted Medical Device / cervical vertebrae	No active disease.	XXXX, pre-op
The cardiomediastinal silhouette is normal in size and contour. Low lung volumes without focal consolidation, pneumothorax or large pleural effusion. Negative for acute bone abnormality.	Lung / hypoinflation	Low lung volumes, otherwise clear.	XXXX-year-old female. Chest pain and shortness of breath for one year. Left arm pain.
The lungs are clear bilaterally. Specifically, no evidence of focal consolidation, pneumothorax, or pleural effusion.. Cardio mediastinal suggests possible right XXXX versus dextrocardia. Visualized osseous structures of the thorax are without acute abnormality.	Deformity / heart / right ; Deformity / mediastinum / right	1. No acute cardiopulmonary abnormality.. 2. Abnormal configuration of the heart and mediastinum suggestive of right aortic XXXX versus dextrocardia.	XXXX-year-old XXXX with positive PPD..
There is interval removal of the tracheostomy tube and right subclavian central venous catheter. The cardiac silhouette is mildly enlarged. There are XXXX XXXX pulmonary opacities with blunting of the bilateral costophrenic XXXX, on the right greater than left, with pleural thickening versus loculated pleural fluid along the peripheral aspect of the right upper lobe. Right perihilar opacities. No pneumothorax identified.	Cardiac Shadow / enlarged / mild ; Opacity / lung ; Costophrenic Angle / bilateral / blunted ; Thickening / pleura / upper lobe / right ; Pleural Effusion / upper lobe / right ; Opacity / lung / hilum / right ; Pulmonary Atelectasis / base / bilateral / mild ; Infiltrate / lung / base / bilateral / mild ; Pleural Effusion / bilateral / small	1. Enlarged cardiac silhouette, possibly consistent with mild cardiomegaly versus a small pericardial effusion. 2. Mild bibasilar atelectasis and/or infiltrates with probable small bilateral pleural effusions, on the right greater than left, and pleural thickening versus loculated pleural fluid along the peripheral aspect of the right upper lobe. .	XXXX-year-old male with a history of partial right lung resection presents for evaluation.
The lungs and pleural spaces show no acute abnormality. Stable paratracheal soft tissue density dating back to exams in XXXX, XXXX confluence of vascular shadows. Lungs are hyperexpanded. Heart size and pulmonary vascularity within normal limits.	Density / paratracheal ; Lung / hyperdistention	1. No acute pulmonary abnormality.	Chest pain and hypertension
Finding data is null	Cardiomegaly / mild	Slight cardiomegaly. Clear lungs.	History of chest pain.
Heart size, cardiomediastinal silhouette, and pulmonary vasculature are within normal limits. There are no infiltrates, effusions, or pneumothorax.	normal	No acute cardiopulmonary process.	XXXX year old, bone marrow XXXX, asymptomatic.
Large medial right upper lobe mass lesion, measuring approximately 5.8 cm x 6.0 cm in diameter. No pneumothorax. No pleural effusions. Lungs clear. Heart size within normal limits. Degenerative changes thoracic spine.	Mass / lung / upper lobe / right / large ; Thoracic Vertebrae / degenerative	Large medial right upper lobe mass highly concerning for primary lung cancer. XXXX chest with intravenous contrast for further evaluation. XXXX XXXX XXXX. XXXX's XXXX was notified of this result at XXXXPM XXXX/XXXX and accepted receipt. Results were faxed. .	XXXX-year-old male, chest pain, no shortness of breath, XXXX.
The heart, pulmonary XXXX and mediastinum are within normal limits. There is no pleural effusion or pneumothorax. There is no focal air space opacity to suggest a pneumonia. There is chronic left hemidiaphragm elevation. The aorta is tortuous and ectatic with atherosclerotic calcifications.	Diaphragm / left / elevated / chronic ; Aorta / tortuous ; Atherosclerosis / aorta	Suspected left hemidiaphragm paralysis. Consider a fluoroscopic evaluation for confirmation. Consider XXXX of the neck and nasopharynx with intravenous contrast if there is no known potential XXXX. Critical result notification documented through Primordial.	XXXX-year-old with shortness of breath for one XXXX. XXXX for 2 weeks.
Finding data is null	Cardiac Shadow / enlarged / borderline ; Mediastinum / prominent / mild ; Catheters, Indwelling	The cardiac silhouette appears be at upper limits of normal to borderline enlarged. The mediastinum and parahilar structures are also slightly prominent but unchanged. Portacatheter is noted with its tip in superior XXXX XXXX. This appears unchanged. Slightly XXXX inspiratory effort is noted on the frontal film. This is unchanged. Osseous structures appear be grossly unremarkable. No pneumothorax or obvious pulmonary lesions seen.	This is a XXXX-year-old male patient with vomiting, history of varices, and previous complaints of chest pain.
The heart size and pulmonary vascularity appear within normal limits. Vascular calcification is identified. Calcified granuloma is present in the right lower lobe. No XXXX nodules are seen. No pneumothorax or pleural effusion is seen. No focal airspace disease is identified.	Calcinosis / blood vessels ; Calcified Granuloma / lung / lower lobe / right	1. No evidence of active disease.	XXXX and congestion.
Moderate bilateral interstitial edema, with cardiomegaly and bilateral effusion consistent with moderate cardiac failure. A large calcified right mediastinal adenopathy, XXXX chronic fungal. No pneumothorax.	Pulmonary Edema / bilateral / interstitial / moderate ; Cardiomegaly ; Pleural Effusion / bilateral ; Heart Failure / moderate ; Calcinosis / mediastinum / lymph nodes / right / large / chronic	Moderate congestive cardiac failure.	INDICATION data is null
XXXX XXXX and lateral views of the chest were obtained XXXX/XXXX. The lung volumes are normal. The lungs are clear and there are no pleural effusions. The mediastinum and pulmonary XXXX are normal. Positioning of the pacemaker generator is unchanged and in its 3 leads remain intact. The additional pacing XXXX over the left atrium also appear unchanged. Thoracolumbar scoliosis is again noted. The XXXX XXXX remain intact.	Implanted Medical Device ; Scoliosis / thoracic vertebrae ; Scoliosis / lumbar vertebrae	No acute cardiopulmonary abnormalities are seen. END OF REPORT.	XXXX-year-old female with XXXX XXXX and TOF.
Heart size and mediastinal contour within normal limits. Multiple calcified granulomas in the bilateral XXXX and lung parenchyma. No focal airspace consolidation, pneumothorax, or large pleural effusion. No acute osseous abnormality.	Calcified Granuloma / lung / bilateral / multiple	No acute cardiopulmonary abnormality.	h/o HTN with headache and dyspnea additionally today
The heart, pulmonary XXXX and mediastinum are within normal limits. There is no pleural effusion or pneumothorax. There is no focal air space opacity to suggest a pneumonia. There are degenerative changes of the spine noted.	Spine / degenerative	No acute cardiopulmonary disease.	XXXX-year-old with chest pain and nausea.
The heart, pulmonary XXXX and mediastinum are within normal limits. There is no pleural effusion or pneumothorax. There is a region of left upper lobe perihilar opacity identified.	Opacity / lung / upper lobe / hilum / left ; Pneumonia / upper lobe / left	Left upper lobe pneumonia. Followup radiographs after appropriate therapy in 8-12 weeks are indicated to exclude an underlying abnormality.	XXXX-year-old with XXXX and XXXX.
The heart and cardiomediastinal silhouette are normal in size and contour. There is no focal airspace opacity, pleural effusion, or pneumothorax. The osseous structures are intact.	normal	No acute cardiopulmonary finding.	XXXX-year-old male with dyspnea chest pain.
The heart size and pulmonary vascularity appear within normal limits. Left pleural effusion is present. A mass density is present in the left midlung zone. This measures approximately 3.2 cm in diameter. Air-fluid level is present behind the heart which probably represents a hiatal hernia. Some XXXX of right lung atelectasis are noted. Osteopenia and XXXX deformities are present in the spine. Multiple surgical clips are noted. No pneumothorax is seen.	Pleural Effusion / base / left ; Density / lung / lingula ; Mass / lung / lingula ; Hernia, Hiatal ; Pulmonary Atelectasis / right ; Bone Diseases, Metabolic / spine ; Deformity / spine ; Surgical Instruments / multiple	1. Left midlung mass. 2. Left base effusion. 3. Probable hiatal hernia.	Lung cancer.
XXXX diffuse right lower lobe airspace opacity is present. There is no pleural effusion or pneumothorax. The heart and mediastinum are normal. The skeletal structures are normal.	Opacity / lung / lower lobe / right / diffuse ; Pneumonia / lower lobe / right	Probable right lower lobe pneumonia.	XXXX for 3 weeks history colon cancer
The cardiomediastinal silhouette is within normal limits for appearance. No focal areas of pulmonary consolidation. No pneumothorax. No pleural effusion. The thoracic spine appears intact.	normal	1. No acute cardiopulmonary process.	XXXX-year-old female with nightsweats and XXXX.
Lungs are relatively clear. Heart size normal. Unfolded aorta. Moderate hiatal hernia. T-spine osteophytes and DISH.	Aorta / tortuous ; Hernia, Hiatal / moderate ; Osteophyte / thoracic vertebrae / multiple ; Hyperostosis, Diffuse Idiopathic Skeletal	Moderate hiatal hernia. No definite pneumonia.	XXXX
Stable cardiomediastinal silhouette with borderline cardiomegaly. No pneumothorax or large pleural effusion. No focal airspace disease. Diffuse interstitial opacities. Bony structures appear intact. Nodular densities consistent with chronic granulomatous disease.	Cardiomegaly / borderline ; Opacity / lung / interstitial / diffuse ; Granulomatous Disease / chronic ; Density / round	Negative for acute cardiopulmonary disease.	XXXX-year-old female with chest pain and XXXX
The cardiac silhouette is enlarged. There are bibasilar airspace opacities left greater than right with small right pleural effusion. No visualized pneumothorax.	Cardiac Shadow / enlarged ; Opacity / lung / base / bilateral ; Pleural Effusion / bilateral / small ; Airspace Disease / lung / base / bilateral	Bibasilar airspace disease left greater than right with small effusions.	XXXX-year-old woman with shortness of breath
Heart size normal. Lungs are clear. XXXX are normal. No pneumonia, effusions, edema, pneumothorax, adenopathy, nodules or masses.	normal	Normal chest No evidence of tuberculosis.	tuberculosis positive PPD
Low lung volumes are present. The heart size and pulmonary vascularity appear within normal limits. There has been interval development of bibasilar opacities. The appearance of the right base opacity XXXX atelectasis. The left base opacities could represent early pneumonia or areas of atelectasis. No pneumothorax or pleural effusion is seen.	Lung / hypoinflation ; Opacity / lung / base / bilateral ; Pulmonary Atelectasis / base / right	1. Low lung volumes. 2. XXXX XXXX opacities. Right base appears to represent atelectasis. Left base could be atelectasis or pneumonia.	Low oxygen saturation.
Cardiac and mediastinal contours are within normal limits. The lungs are clear. Bony structures are intact.	normal	No acute findings.	Preop surgery
Normal cardiomediastinal contours. No focal consolidation or pleural effusions. No pneumothorax.	normal	No acute cardiopulmonary abnormalities.	XXXX distress
Cardiomediastinal silhouette is within normal limits for size and contour. Lungs are hyperinflated with flattening of the diaphragms consistent with emphysematous change. No evidence of focal airspace disease, pleural effusion, or pneumothorax. Multilevel degenerative changes of the spine are noted.	Lung / hyperdistention ; Diaphragm / bilateral / flattened ; Pulmonary Emphysema ; Spine / degenerative / multiple	1. Emphysematous change without evidence of acute cardiopulmonary process.	XXXX
Cardiac and mediastinal contours are within normal limits. Prior granulomatous disease. The lungs are otherwise clear. Bony structures are intact.	Granulomatous Disease	NO acute preoperative findings.	Preop XXXX ankle surgery
The trachea is midline. Cardiomediastinal silhouette is normal in size and contour. The lungs are clear without evidence of acute infiltrate or effusion. There is no pneumothorax. The visualized bony structures reveal no acute abnormalities.	normal	No acute cardiopulmonary abnormalities.	chest pain
Overall low lung volumes with mild patchy bibasilar airspace disease. This most XXXX represents atelectasis given the low lung volumes. No pleural effusions or pneumothoraces. Heart and mediastinum of normal size and contour.	Lung / hypoinflation ; Airspace Disease / lung / base / bilateral / patchy / mild ; Pulmonary Atelectasis	Mild patchy bibasilar airspace disease most XXXX representing atelectasis given the low lung volumes.	XXXX
Finding data is null	normal	Heart size normal. Lungs are clear.	XXXX XXXX
The cardiomediastinal silhouette and pulmonary vasculature are within normal limits in size. The lungs are mildly hyperinflated with flattening of the diaphragms and expansion of the retrosternal clear space. Compared with prior exam, there has been interval resolution of previously demonstrated bibasilar infiltrates. There is minimal XXXX scarring or atelectasis in the right midlung. There is no XXXX focal airspace disease. There is no pneumothorax or pleural effusion. There are no acute bony findings.	Lung / hyperdistention / mild ; Diaphragm / bilateral / flattened ; Cicatrix / lung / middle lobe / right / mild ; Pulmonary Atelectasis / middle lobe / right / mild ; Pulmonary Emphysema	1. Interval resolution of bibasilar airspace disease. 2. Hyperinflation with chronic changes of emphysema. .	Nausea, vomiting x2 weeks. Dialysis patient.
No pneumothorax, pleural effusion , or focal airspace disease. Heart size within normal limits. Cardiomediastinal silhouette is clear. Bony structures appear intact.	normal	Negative for acute cardiopulmonary disease. No fractures identified.	XXXX-year-old male status post assault
The heart is normal in size. The mediastinum is unremarkable. The lungs are hypoinflated but clear.	Lung / hypoinflation	No acute disease.	EVALUATE FOR METASTATIC DISEASE; history of renal cancer; preop adrenalectomy, left-sided pain
The lungs are mildly hyperexpanded. There is no focal airspace consolidation. No suspicious pulmonary mass or nodule is identified. Heart size and mediastinal contour are within normal limits. There are degenerative changes of the spine.	Lung / hyperdistention / mild ; Spine / degenerative	1. No focal airspace consolidation. 2. Mildly hyperexpanded lungs, suggestive of emphysema.	XXXX-year-old female with history breast cancer, XXXX for 2 weeks. 272.4
Finding data is null	Pneumothorax / apex / right ; Pulmonary Atelectasis / base / left / mild	Stable 1 cm right apical pneumothorax. Minimal atelectasis left base. Heart size normal	History of chest tube removal
Finding data is null	No Indexing	Compared with prior examination mildly improved inspirational XXXX. Lung parenchyma is not clear. No acute airspace disease, large pleural effusions or pulmonary edema. No XXXX of acute cardiopulmonary disease.	INDICATION: ASPIRATION PNA; aspiration PNA. Pt. states no chest pain, sob, XXXX. XXXX states prev inj/XXXX to chest/ Hx of smoking
The heart and mediastinum are unremarkable. The lungs are clear without infiltrate. There is no effusion or pneumothorax.	normal	1. No acute cardiopulmonary disease.	XXXX-year-old with a XXXX.
Minimal left costophrenic XXXX airspace disease and/or pleural effusion. Lungs are otherwise clear. No pneumothorax. Heart and mediastinum are stable with normal sized heart. There is tortuosity and ectasia of the aorta. Degenerative changes in the spine.	Airspace Disease / lung / costophrenic angle / left / mild ; Pleural Effusion / costophrenic angle / left / mild ; Aorta / tortuous ; Spine / degenerative	Minimal left costophrenic XXXX airspace disease and/or pleural effusion.	h/o dyspnea
there is a rounded opacity in the right lower zone measuring 2.0 cm which is XXXX to be in the posterobasal segment. There is of uncertain etiology but would benefit from followup at XXXX some concern for neoplasm. A XXXX is recommended. No airspace disease, effusion or cavitary nodule. Normal heart size and mediastinum. Visualized XXXX of the chest XXXX are within normal limits.	Opacity / lung / lower lobe / right / posterior / round ; Nodule / lung / lower lobe / right	2 cm noncalcified nodule in the right lower lobe would benefit from a XXXX.	INDICATION data is null
The cardiomediastinal silhouette and pulmonary vasculature are within normal limits. There is no pneumothorax or pleural effusion. There are no focal areas of consolidation.	normal	No acute cardiopulmonary abnormalities.	XXXX/XXXX/weakness/lp today.
There is interstitial thickening bilaterally, more prominent in the bases. The cardiomediastinal silhouette is normal in size and appearance. There is hyperexpansion. No XXXX infiltrates. Two bullae are seen in the right upper lung. Small calcified granuloma stable from prior exam.	Thickening / lung / base / bilateral / interstitial ; Lung / hyperdistention ; Blister / lung / upper lobe / right ; Calcified Granuloma / small ; Pulmonary Disease, Chronic Obstructive	Stable changes of COPD.	Rales in right mid and lower lung XXXX.
Minimal right sided perihilar atelectasis. The trachea is midline. Negative for pneumothorax, pleural effusion. The heart size is normal.	Pulmonary Atelectasis / hilum / right / mild	1. No acute cardiopulmonary abnormality. No active disease.	The patient is a XXXX-year-old male with alcoholic hepatitis, XXXX withdrawal, on CIWA. Smoking history with XXXX COPD, elevated XXXX XXXX.
Finding data is null	normal	No active cardiopulmonary disease.	PAIN
AP and lateral views of the chest were obtained. The heart is normal size. Mediastinum is unremarkable. Lungs are hypoinflated but clear. No focal consolidation is seen.	Lung / hypoinflation	No acute disease	MVC
Heart size and mediastinal contour are normal. Pulmonary vascularity is normal. Lungs are clear. No pleural effusions or pneumothoraces.	normal	Normal chest.	XXXX
Sternotomy sutures and bypass grafts have been placed in the interval. Both lungs remain clear and expanded with no infiltrates. Pulmonary XXXX are normal.	Sutures / sternum	Post operative chest with no acute disease.	SP CABG SOB NO RALES
Cardiac and mediastinal contours are within normal limits. Granulomatous calcifications in the paratracheal region. Mild streaky scarring in the right upper lobe. No active pneumonia. Bony structures are intact.	Calcified Granuloma / paratracheal ; Cicatrix / lung / upper lobe / right / streaky / mild	No lobar pneumonia is present.	Pneumonia followup
Finding data is null	Calcified Granuloma / lung / middle lobe / right	Heart size is normal. Lungs are clear. Calcified stable right midlung granulomas.	History of Wheezing.
There is stable prominence of the pulmonary interstitium. XXXX and fluid containing density seen adjacent to the heart is stable, most consistent with a moderate sized hiatal hernia. There is stable tortuosity and/or ectasia of the thoracic aorta, with calcification of the aortic XXXX. No pleural effusion, focal airspace disease or pneumothorax. Stable exaggerated kyphosis of the thoracic spine, stable anterior wedge deformities of at XXXX 2 thoracic vertebral bodies at the apex of the kyphotic curvature. Diffuse osteopenia.	Lung / interstitial / prominent ; Density / mediastinum ; Hernia, Hiatal / moderate ; Aorta, Thoracic / tortuous ; Calcinosis / aorta ; Kyphosis / thoracic vertebrae / severe ; Deformity / thoracic vertebrae / anterior / multiple ; Bone Diseases, Metabolic / diffuse	1. No acute pulmonary disease. 2. Stable moderate hiatal hernia.	XXXX-year-old female with chest pain.
The trachea is midline. The cardiomediastinal silhouette is normal in contour and unchanged in comparison to prior exams. The lungs are clear with no evidence of acute infiltrate or effusion. There is no pneumothorax. The visualized bony structures reveal no acute abnormalities.	normal	No acute cardiopulmonary abnormality.	pre op and findings of DVT
Normal heart size and mediastinal contours. Clear lungs. No pneumothorax or pleural effusion. Unremarkable XXXX.	normal	No acute cardiopulmonary process. .	Difficulty breathing.
A large pleural air collection is present on the right. Mediastinum is shifted to the left as compared to the previous examination. The right lower lobe is totally opaque.	Pneumothorax / right / large ; Shift / mediastinum / left ; Opacity / lung / lower lobe / right / severe ; Pulmonary Atelectasis / lower lobe / right / severe	Large right XXXX pneumothorax with associated complete collapse of the right lower lobe.	dyspnea
The cardiomediastinal silhouette is within normal limits for size and contour. The lungs are normally inflated without evidence of focal airspace disease, pleural effusion, or pneumothorax. No acute osseus abnormality.	normal	No acute cardiopulmonary process.	XXXX-year-old female, MVC.
The cardiomediastinal silhouette is normal in size and contour. No focal consolidation, pneumothorax or large pleural effusion. Normal XXXX. XXXX cholecystectomy.	Lung / hypoinflation	Low lung volumes, otherwise clear.	XXXX-year-old female. Pain.
Chronic bilateral emphysematous changes. The heart size and mediastinal silhouette are within normal limits for contour. The lungs are clear. No pneumothorax or pleural effusions. The XXXX are intact.	Emphysema / bilateral / chronic / severe	Significant bilateral emphysematous changes. No acute cardiopulmonary abnormalities.	XXXX-year-old male with dizziness.